YEAR,MONTH,IDADMIN1,IDADMIN2,ADMIN1,ADMIN2,CLIN,CONF_TOTAL,CONF_MIC,CONF_RDT,CONF_PCR,POS_0_11_MO_M,POS_0_11_MO_F,PO_1_4_YO_M,PO_1_4_YO_F,POS_5_9_YO_M,POS_5_9_YO_F,POS_10_14_YO_M,POS_10_14_YO_F,POS_15_64_YO_M,POS_15_64_YO_F,POS_OVER_64_M,POS_OVER_64_F,POS_0_4,POS_5_9,POS_10_14,POS_15_64,POS_OVER_64,POS_PREGNANT,POS_PF,POS_PV,POS_PM_PO,POS_MIX,POS_PK,POS_MALE,POS_FEMALE,POS_GENDER_TOTAL,POS_SPECIES_TOTAL
2010,1,94,9403,PAPUA,JAYAPURA,4244,0,2683,509,0,17,21,133,90,81,69,56,52,176,193,0,0,261,150,108,369,0,19,709,176,1,47,0,463,425,888,933
2010,1,94,9471,PAPUA,KOTA JAYAPURA,5164,0,5126,0,0,22,15,121,102,122,9,60,63,325,296,0,0,260,131,123,621,0,22,885,351,0,28,0,650,485,1135,1264
2010,1,94,9420,PAPUA,KEEROM,3228,0,2863,365,0,30,11,140,120,103,98,56,57,353,265,0,0,301,201,113,618,0,20,944,300,1,75,0,682,551,1233,1320
2010,1,94,9419,PAPUA,SARMI,0,0,0,0,0,0,0,0,0,0,0,0,0,0,0,0,0,0,0,0,0,0,0,0,0,0,0,0,0,0,0,0
2010,1,94,9409,PAPUA,BIAK NUMFOR,2627,0,2149,50,0,36,35,152,147,69,91,36,36,132,336,0,0,370,160,72,468,0,7,85,1089,0,9,0,425,645,1070,1183
2010,1,94,9427,PAPUA,SUPIORI,1755,0,1576,11,0,5,2,18,11,12,8,8,11,34,29,0,0,36,20,19,63,0,1,56,96,2,2,0,77,61,138,156
2010,1,94,9401,PAPUA,MERAUKE,1210,0,884,200,0,12,9,36,33,25,24,13,8,38,43,0,0,90,49,21,81,0,1,3,257,0,0,0,124,117,241,260
2010,1,94,9414,PAPUA,MAPPI,660,0,169,21,0,3,2,9,11,15,22,11,6,13,7,0,0,25,37,17,20,0,2,67,50,0,0,0,51,48,99,117
2010,1,94,9413,PAPUA,BOVEN DIGOEL,974,0,484,30,0,15,3,38,38,21,17,9,10,125,81,0,0,94,38,19,206,0,31,201,155,0,8,0,208,149,357,364
2010,1,94,9404,PAPUA,NABIRE,1112,0,336,1,0,4,2,20,15,11,24,23,24,59,61,0,0,41,35,47,120,0,0,177,62,0,6,0,117,126,243,245
2010,1,94,9408,PAPUA,KEPULAUAN YAPEN,2640,0,1422,58,0,54,32,139,91,55,91,42,29,154,155,0,0,316,146,71,309,0,2,372,320,0,15,0,444,398,842,707
2010,1,94,9412,PAPUA,MIMIKA,2003,0,1493,37,0,32,24,110,117,75,70,33,38,143,86,0,0,283,145,71,229,0,6,730,99,90,35,0,393,335,728,954
2010,1,94,9410,PAPUA,PANIAI,9023,0,7384,585,0,71,67,274,268,267,233,174,141,1064,930,0,0,680,500,315,1994,0,91,2410,1574,0,330,0,1850,1639,3489,4314
2010,1,94,9415,PAPUA,ASMAT,351,0,0,0,0,0,0,10,8,11,14,22,27,111,125,0,0,18,25,49,236,0,0,139,164,0,41,0,154,174,328,344
2010,1,94,9426,PAPUA,WAROPEN,0,0,0,0,0,0,0,0,0,0,0,0,0,0,0,0,0,0,0,0,0,0,0,0,0,0,0,0,0,0,0,0
2010,1,94,9402,PAPUA,JAYAWIJAYA,0,0,0,0,0,0,0,0,0,0,0,0,0,0,0,0,0,0,0,0,0,0,0,0,0,0,0,0,0,0,0,0
2010,1,94,9411,PAPUA,PUNCAK JAYA,0,0,0,0,0,0,0,0,0,0,0,0,0,0,0,0,0,0,0,0,0,0,0,0,0,0,0,0,0,0,0,0
2010,1,94,9418,PAPUA,TOLIKARA,0,0,0,0,0,0,0,0,0,0,0,0,0,0,0,0,0,0,0,0,0,0,0,0,0,0,0,0,0,0,0,0
2010,1,94,9416,PAPUA,YAHUKIMO,0,0,0,0,0,0,0,0,0,0,0,0,0,0,0,0,0,0,0,0,0,0,0,0,0,0,0,0,0,0,0,0
2010,1,94,9417,PAPUA,PEGUNUNGAN BINTANG,0,0,0,0,0,0,0,0,0,0,0,0,0,0,0,0,0,0,0,0,0,0,0,0,0,0,0,0,0,0,0,0
2010,2,94,9403,PAPUA,JAYAPURA,3687,0,2112,453,0,31,17,130,104,93,88,62,50,113,138,0,0,282,181,112,251,0,17,785,176,1,60,0,429,397,826,1022
2010,2,94,9471,PAPUA,KOTA JAYAPURA,4888,0,4588,0,0,19,13,110,119,118,78,58,59,318,289,0,0,261,196,117,607,0,22,860,304,1,38,0,623,558,1181,1203
2010,2,94,9420,PAPUA,KEEROM,3374,0,3097,277,0,26,12,99,85,89,65,40,31,251,219,0,0,222,154,71,470,0,7,654,223,0,63,0,505,412,917,940
2010,2,94,9419,PAPUA,SARMI,0,0,0,0,0,0,0,0,0,0,0,0,0,0,0,0,0,0,0,0,0,0,0,0,0,0,0,0,0,0,0,0
2010,2,94,9409,PAPUA,BIAK NUMFOR,1598,0,1297,16,0,36,35,115,86,51,61,29,27,80,233,0,0,272,112,56,313,0,118,50,750,0,5,0,311,442,753,805
2010,2,94,9427,PAPUA,SUPIORI,297,0,34,66,0,0,1,6,7,3,6,4,8,6,8,0,0,14,9,12,14,0,0,20,6,0,27,0,19,30,49,53
2010,2,94,9401,PAPUA,MERAUKE,0,0,0,0,0,0,0,0,0,0,0,0,0,0,0,0,0,0,0,0,0,0,0,0,0,0,0,0,0,0,0,0
2010,2,94,9414,PAPUA,MAPPI,794,0,185,20,0,3,3,10,13,16,12,18,10,20,13,0,0,29,28,28,33,0,0,66,63,0,2,0,67,51,118,131
2010,2,94,9413,PAPUA,BOVEN DIGOEL,367,0,313,54,0,16,10,23,22,11,5,5,7,59,36,0,0,71,16,12,95,0,1,100,91,0,10,0,114,80,194,201
2010,2,94,9404,PAPUA,NABIRE,1184,0,874,21,0,26,31,104,75,65,69,35,28,153,139,0,0,236,134,63,292,0,2,303,238,0,17,0,383,342,725,558
2010,2,94,9408,PAPUA,KEPULAUAN YAPEN,2124,0,1728,72,0,60,43,149,105,101,74,45,40,165,210,0,0,357,175,85,375,0,55,965,113,0,28,0,520,472,992,1106
2010,2,94,9412,PAPUA,MIMIKA,9445,0,8379,923,0,39,37,227,224,220,194,159,135,994,865,0,0,527,414,294,1859,0,54,1739,1369,28,189,0,1639,1455,3094,3325
2010,2,94,9410,PAPUA,PANIAI,183,0,0,0,0,0,0,4,4,10,11,17,19,122,115,0,0,8,21,36,237,0,9,142,168,0,12,0,153,149,302,322
2010,2,94,9415,PAPUA,ASMAT,1138,0,622,0,0,5,3,23,9,5,14,5,12,24,20,0,0,40,19,17,44,0,0,217,51,23,18,0,62,58,120,309
2010,2,94,9426,PAPUA,WAROPEN,0,0,0,0,0,0,0,0,0,0,0,0,0,0,0,0,0,0,0,0,0,0,0,0,0,0,0,0,0,0,0,0
2010,2,94,9402,PAPUA,JAYAWIJAYA,0,0,0,0,0,0,0,0,0,0,0,0,0,0,0,0,0,0,0,0,0,0,0,0,0,0,0,0,0,0,0,0
2010,2,94,9411,PAPUA,PUNCAK JAYA,0,0,0,0,0,0,0,0,0,0,0,0,0,0,0,0,0,0,0,0,0,0,0,0,0,0,0,0,0,0,0,0
2010,2,94,9418,PAPUA,TOLIKARA,0,0,0,0,0,0,0,0,0,0,0,0,0,0,0,0,0,0,0,0,0,0,0,0,0,0,0,0,0,0,0,0
2010,2,94,9416,PAPUA,YAHUKIMO,0,0,0,0,0,0,0,0,0,0,0,0,0,0,0,0,0,0,0,0,0,0,0,0,0,0,0,0,0,0,0,0
2010,2,94,9417,PAPUA,PEGUNUNGAN BINTANG,0,0,0,0,0,0,0,0,0,0,0,0,0,0,0,0,0,0,0,0,0,0,0,0,0,0,0,0,0,0,0,0
2010,3,94,9403,PAPUA,JAYAPURA,5175,0,3125,706,0,26,27,133,123,128,118,81,66,260,315,0,0,309,246,147,575,0,14,934,242,1,132,0,628,649,1277,1309
2010,3,94,9471,PAPUA,KOTA JAYAPURA,5830,0,5336,370,0,24,20,126,115,159,108,71,71,422,288,0,0,285,267,142,710,0,17,972,411,3,46,0,802,602,1404,1432
2010,3,94,9420,PAPUA,KEEROM,3633,0,3178,455,0,31,27,146,109,97,93,63,49,300,337,0,0,313,190,112,637,0,21,792,438,1,93,0,637,615,1252,1324
2010,3,94,9419,PAPUA,SARMI,282,0,152,90,0,2,10,15,9,20,17,15,24,28,44,0,0,36,37,39,72,0,2,49,110,23,20,0,80,104,184,202
2010,3,94,9409,PAPUA,BIAK NUMFOR,2436,0,1713,32,0,61,51,118,135,69,78,36,33,163,191,0,0,365,147,69,354,0,4,41,954,0,6,0,447,488,935,1001
2010,3,94,9427,PAPUA,SUPIORI,122,0,23,34,0,3,1,2,0,1,0,0,0,8,3,0,0,6,1,0,11,0,0,12,5,0,2,0,14,4,18,19
2010,3,94,9401,PAPUA,MERAUKE,1491,0,729,664,0,4,5,18,18,12,13,10,10,35,34,0,0,45,25,20,69,0,5,16,154,0,3,0,79,80,159,173
2010,3,94,9414,PAPUA,MAPPI,1408,0,779,27,0,18,21,49,52,34,31,17,18,46,88,0,0,140,65,35,134,0,2,48,332,0,2,0,164,210,374,382
2010,3,94,9413,PAPUA,BOVEN DIGOEL,1049,0,447,137,0,8,7,26,10,16,8,5,6,92,51,0,0,51,24,11,143,0,165,137,81,0,13,0,147,82,229,231
2010,3,94,9404,PAPUA,NABIRE,2333,0,2154,94,0,19,34,99,62,60,63,53,54,193,140,0,0,214,123,107,333,0,302,474,331,2,52,0,424,353,777,859
2010,3,94,9408,PAPUA,KEPULAUAN YAPEN,2370,0,1585,151,0,53,47,127,144,95,70,43,29,155,221,0,0,371,165,72,376,0,47,894,114,0,13,0,473,511,984,1021
2010,3,94,9412,PAPUA,MIMIKA,13704,0,12305,925,0,66,63,351,340,324,283,204,212,1266,1146,0,0,820,607,416,2412,0,36,2359,1856,171,168,0,2211,2044,4255,4554
2010,3,94,9410,PAPUA,PANIAI,629,0,132,338,0,0,0,3,3,9,10,22,18,103,98,0,0,6,19,40,201,0,13,97,187,0,11,0,137,129,266,295
2010,3,94,9415,PAPUA,ASMAT,1312,0,447,49,0,4,6,37,27,16,7,15,9,31,31,0,0,74,23,24,62,0,1,302,90,0,43,0,103,80,183,435
2010,3,94,9426,PAPUA,WAROPEN,0,0,0,0,0,0,0,0,0,0,0,0,0,0,0,0,0,0,0,0,0,0,0,0,0,0,0,0,0,0,0,0
2010,3,94,9402,PAPUA,JAYAWIJAYA,0,0,0,0,0,0,0,0,0,0,0,0,0,0,0,0,0,0,0,0,0,0,0,0,0,0,0,0,0,0,0,0
2010,3,94,9411,PAPUA,PUNCAK JAYA,0,0,0,0,0,0,0,0,0,0,0,0,0,0,0,0,0,0,0,0,0,0,0,0,0,0,0,0,0,0,0,0
2010,3,94,9418,PAPUA,TOLIKARA,0,0,0,0,0,0,0,0,0,0,0,0,0,0,0,0,0,0,0,0,0,0,0,0,0,0,0,0,0,0,0,0
2010,3,94,9416,PAPUA,YAHUKIMO,0,0,0,0,0,0,0,0,0,0,0,0,0,0,0,0,0,0,0,0,0,0,0,0,0,0,0,0,0,0,0,0
2010,3,94,9417,PAPUA,PEGUNUNGAN BINTANG,0,0,0,0,0,0,0,0,0,0,0,0,0,0,0,0,0,0,0,0,0,0,0,0,0,0,0,0,0,0,0,0
2010,4,94,9403,PAPUA,JAYAPURA,4852,0,3028,531,0,21,73,129,111,137,101,92,63,234,262,0,0,334,238,155,496,0,15,883,203,1,123,0,613,610,1223,1210
2010,4,94,9471,PAPUA,KOTA JAYAPURA,5740,0,5164,180,0,14,10,127,101,128,75,67,69,404,315,0,0,252,203,136,719,0,15,908,405,3,29,0,740,570,1310,1345
2010,4,94,9420,PAPUA,KEEROM,2287,0,1693,594,0,22,12,92,68,62,51,33,38,223,157,0,0,194,113,71,380,0,6,485,251,2,59,0,432,326,758,797
2010,4,94,9419,PAPUA,SARMI,225,0,143,42,0,6,11,9,8,16,20,8,7,28,25,0,0,34,36,15,53,0,0,89,47,0,9,0,67,71,138,145
2010,4,94,9409,PAPUA,BIAK NUMFOR,2735,0,1726,157,0,35,45,189,109,101,88,39,31,128,284,0,0,378,189,70,412,0,4,77,1097,0,7,0,492,557,1049,1181
2010,4,94,9427,PAPUA,SUPIORI,257,0,90,26,0,2,1,10,7,10,8,9,13,10,1,0,0,20,18,22,11,0,0,34,37,0,25,0,41,30,71,96
2010,4,94,9401,PAPUA,MERAUKE,1057,0,779,278,0,4,6,27,26,23,22,15,21,47,57,0,0,63,45,36,104,0,0,18,265,0,1,0,116,132,248,284
2010,4,94,9414,PAPUA,MAPPI,1415,0,1075,45,0,22,15,93,80,39,19,26,29,86,108,0,0,210,58,55,194,0,1,49,494,0,4,0,266,251,517,547
2010,4,94,9413,PAPUA,BOVEN DIGOEL,827,0,531,94,0,10,13,54,32,32,22,16,13,121,105,0,0,109,54,29,226,0,41,210,202,0,17,0,233,185,418,429
2010,4,94,9404,PAPUA,NABIRE,2052,0,1845,0,0,21,23,72,78,74,60,84,71,194,161,0,0,194,134,155,355,0,1,475,388,1,25,0,445,393,838,889
2010,4,94,9408,PAPUA,KEPULAUAN YAPEN,1666,0,1246,222,0,50,45,151,119,75,45,32,37,144,183,0,0,365,120,69,327,0,58,813,81,0,27,0,452,429,881,921
2010,4,94,9412,PAPUA,MIMIKA,12301,0,9379,923,0,33,32,240,234,244,225,154,209,1094,901,0,0,539,469,363,1995,0,36,1675,1584,76,141,0,1765,1601,3366,3476
2010,4,94,9410,PAPUA,PANIAI,569,0,126,273,0,0,0,4,5,7,6,25,26,71,69,0,0,9,13,51,140,0,0,118,92,0,10,0,107,106,213,220
2010,4,94,9415,PAPUA,ASMAT,1323,0,82,65,0,6,7,18,15,8,12,3,8,17,21,0,0,46,20,11,38,0,1,83,46,0,15,0,52,63,115,144
2010,4,94,9426,PAPUA,WAROPEN,0,0,0,0,0,0,0,0,0,0,0,0,0,0,0,0,0,0,0,0,0,0,0,0,0,0,0,0,0,0,0,0
2010,4,94,9402,PAPUA,JAYAWIJAYA,0,0,0,0,0,0,0,0,0,0,0,0,0,0,0,0,0,0,0,0,0,0,0,0,0,0,0,0,0,0,0,0
2010,4,94,9411,PAPUA,PUNCAK JAYA,0,0,0,0,0,0,0,0,0,0,0,0,0,0,0,0,0,0,0,0,0,0,0,0,0,0,0,0,0,0,0,0
2010,4,94,9418,PAPUA,TOLIKARA,0,0,0,0,0,0,0,0,0,0,0,0,0,0,0,0,0,0,0,0,0,0,0,0,0,0,0,0,0,0,0,0
2010,4,94,9416,PAPUA,YAHUKIMO,0,0,0,0,0,0,0,0,0,0,0,0,0,0,0,0,0,0,0,0,0,0,0,0,0,0,0,0,0,0,0,0
2010,4,94,9417,PAPUA,PEGUNUNGAN BINTANG,0,0,0,0,0,0,0,0,0,0,0,0,0,0,0,0,0,0,0,0,0,0,0,0,0,0,0,0,0,0,0,0
2010,5,94,9403,PAPUA,JAYAPURA,5985,0,3708,645,0,22,17,155,124,160,122,77,72,256,257,0,0,318,282,149,513,0,14,997,237,5,100,0,670,592,1262,1339
2010,5,94,9471,PAPUA,KOTA JAYAPURA,6517,0,5732,294,0,22,26,131,129,160,143,104,72,425,354,0,0,308,303,176,779,0,9,1115,492,0,35,0,842,724,1566,1642
2010,5,94,9420,PAPUA,KEEROM,2662,0,2126,536,0,15,20,113,73,74,63,44,78,257,218,0,0,221,137,122,475,0,11,542,382,1,76,0,503,452,955,1001
2010,5,94,9419,PAPUA,SARMI,0,0,76,12,0,0,0,0,0,13,10,8,10,19,24,0,0,0,23,18,43,0,0,65,18,0,5,0,40,44,84,88
2010,5,94,9409,PAPUA,BIAK NUMFOR,3416,0,2005,67,0,38,41,53,50,218,122,58,64,114,316,0,0,182,340,122,430,0,28,68,1329,0,12,0,481,593,1074,1409
2010,5,94,9427,PAPUA,SUPIORI,128,0,25,15,0,0,1,1,3,5,0,2,2,3,6,0,0,5,5,4,9,0,0,14,13,0,1,0,11,12,23,28
2010,5,94,9401,PAPUA,MERAUKE,1233,0,757,476,0,9,13,42,27,29,11,19,21,54,75,0,0,91,40,40,129,0,0,37,298,0,1,0,153,147,300,336
2010,5,94,9414,PAPUA,MAPPI,1403,0,884,122,0,16,15,55,60,17,29,22,21,55,79,0,0,146,46,43,134,0,0,61,313,0,0,0,165,204,369,374
2010,5,94,9413,PAPUA,BOVEN DIGOEL,1012,0,661,98,0,7,12,38,48,44,37,24,26,125,105,0,0,105,81,50,230,0,4,271,246,0,35,0,238,228,466,552
2010,5,94,9404,PAPUA,NABIRE,4528,0,2220,55,0,72,67,184,142,104,107,66,91,326,277,0,0,465,211,157,603,0,8,944,650,3,66,0,752,684,1436,1663
2010,5,94,9408,PAPUA,KEPULAUAN YAPEN,2259,0,1183,213,0,58,43,98,109,69,52,35,42,161,144,0,0,308,121,77,305,0,43,811,48,0,23,0,421,390,811,882
2010,5,94,9412,PAPUA,MIMIKA,14932,0,12018,978,0,74,73,445,471,346,326,240,215,1629,1534,0,0,1063,672,455,3163,0,27,2797,2344,206,240,0,2734,2619,5353,5587
2010,5,94,9410,PAPUA,PANIAI,716,0,184,341,0,0,0,2,3,11,9,22,21,98,92,0,0,5,20,43,190,0,0,164,91,0,11,0,133,125,258,266
2010,5,94,9415,PAPUA,ASMAT,0,0,0,0,0,0,0,0,0,0,0,0,0,0,0,0,0,0,0,0,0,0,0,0,0,0,0,0,0,0,0,0
2010,5,94,9426,PAPUA,WAROPEN,0,0,0,0,0,0,0,0,0,0,0,0,0,0,0,0,0,0,0,0,0,0,0,0,0,0,0,0,0,0,0,0
2010,5,94,9402,PAPUA,JAYAWIJAYA,0,0,0,0,0,0,0,0,0,0,0,0,0,0,0,0,0,0,0,0,0,0,0,0,0,0,0,0,0,0,0,0
2010,5,94,9411,PAPUA,PUNCAK JAYA,0,0,0,0,0,0,0,0,0,0,0,0,0,0,0,0,0,0,0,0,0,0,0,0,0,0,0,0,0,0,0,0
2010,5,94,9418,PAPUA,TOLIKARA,0,0,0,0,0,0,0,0,0,0,0,0,0,0,0,0,0,0,0,0,0,0,0,0,0,0,0,0,0,0,0,0
2010,5,94,9416,PAPUA,YAHUKIMO,0,0,0,0,0,0,0,0,0,0,0,0,0,0,0,0,0,0,0,0,0,0,0,0,0,0,0,0,0,0,0,0
2010,5,94,9417,PAPUA,PEGUNUNGAN BINTANG,0,0,0,0,0,0,0,0,0,0,0,0,0,0,0,0,0,0,0,0,0,0,0,0,0,0,0,0,0,0,0,0
2010,6,94,9403,PAPUA,JAYAPURA,7058,0,4535,620,0,30,33,208,170,192,190,104,84,323,439,0,0,441,382,188,762,0,3,1400,304,4,115,0,857,916,1773,1823
2010,6,94,9471,PAPUA,KOTA JAYAPURA,7284,0,6023,1211,0,19,35,130,126,149,111,100,79,434,314,0,0,310,260,179,748,0,22,1056,421,3,69,0,832,665,1497,1549
2010,6,94,9420,PAPUA,KEEROM,2759,0,2360,399,0,29,16,87,102,104,70,55,54,242,182,0,0,234,174,109,424,0,10,562,331,2,74,0,517,424,941,969
2010,6,94,9419,PAPUA,SARMI,0,0,0,0,0,0,0,0,0,0,0,0,0,0,0,0,0,0,0,0,0,0,0,0,0,0,0,0,0,0,0,0
2010,6,94,9409,PAPUA,BIAK NUMFOR,1834,0,1145,44,0,25,32,129,101,71,70,21,24,88,220,0,0,287,141,45,308,0,37,13,839,0,2,0,334,447,781,854
2010,6,94,9427,PAPUA,SUPIORI,468,0,9,86,0,0,0,3,2,7,6,6,5,7,8,0,0,5,13,11,15,0,0,14,3,0,34,0,23,21,44,51
2010,6,94,9401,PAPUA,MERAUKE,979,0,691,288,0,13,10,42,34,20,19,15,13,51,44,0,0,99,39,28,95,0,0,21,265,0,1,0,141,120,261,287
2010,6,94,9414,PAPUA,MAPPI,1368,0,964,136,0,8,7,70,53,25,21,12,8,46,114,0,0,138,46,20,160,0,5,48,72,243,7,0,161,203,364,370
2010,6,94,9413,PAPUA,BOVEN DIGOEL,957,0,447,199,0,6,11,24,17,30,31,21,22,117,101,0,0,58,61,43,218,0,1,219,184,0,36,0,198,182,380,439
2010,6,94,9404,PAPUA,NABIRE,2678,0,2368,280,0,64,80,157,156,105,108,127,165,331,302,0,0,457,213,292,633,0,13,894,909,2,89,0,784,811,1595,1894
2010,6,94,9408,PAPUA,KEPULAUAN YAPEN,1376,0,881,149,0,34,26,93,96,71,61,17,13,103,107,0,0,249,132,30,210,0,37,594,46,0,16,0,318,303,621,656
2010,6,94,9412,PAPUA,MIMIKA,14807,0,13770,1016,0,141,126,409,390,322,310,227,237,1597,1436,0,0,1066,632,464,3033,0,40,2971,2038,335,402,0,2696,2499,5195,5746
2010,6,94,9410,PAPUA,PANIAI,839,0,188,444,0,0,0,7,7,16,17,38,44,142,126,0,0,14,33,82,268,0,0,264,131,0,21,0,203,194,397,416
2010,6,94,9415,PAPUA,ASMAT,0,0,0,0,0,0,0,0,0,0,0,0,0,0,0,0,0,0,0,0,0,0,0,0,0,0,0,0,0,0,0,0
2010,6,94,9426,PAPUA,WAROPEN,0,0,0,0,0,0,0,0,0,0,0,0,0,0,0,0,0,0,0,0,0,0,0,0,0,0,0,0,0,0,0,0
2010,6,94,9402,PAPUA,JAYAWIJAYA,0,0,0,0,0,0,0,0,0,0,0,0,0,0,0,0,0,0,0,0,0,0,0,0,0,0,0,0,0,0,0,0
2010,6,94,9411,PAPUA,PUNCAK JAYA,0,0,0,0,0,0,0,0,0,0,0,0,0,0,0,0,0,0,0,0,0,0,0,0,0,0,0,0,0,0,0,0
2010,6,94,9418,PAPUA,TOLIKARA,0,0,0,0,0,0,0,0,0,0,0,0,0,0,0,0,0,0,0,0,0,0,0,0,0,0,0,0,0,0,0,0
2010,6,94,9416,PAPUA,YAHUKIMO,0,0,0,0,0,0,0,0,0,0,0,0,0,0,0,0,0,0,0,0,0,0,0,0,0,0,0,0,0,0,0,0
2010,6,94,9417,PAPUA,PEGUNUNGAN BINTANG,0,0,0,0,0,0,0,0,0,0,0,0,0,0,0,0,0,0,0,0,0,0,0,0,0,0,0,0,0,0,0,0
2010,7,94,9403,PAPUA,JAYAPURA,6350,0,3789,929,0,16,22,179,162,150,159,97,84,290,358,0,0,379,309,181,648,0,0,1049,292,1,175,0,732,785,1517,1517
2010,7,94,9471,PAPUA,KOTA JAYAPURA,6785,0,5755,730,0,12,20,130,145,135,125,112,95,515,338,0,0,307,260,207,853,0,0,1047,523,1,60,0,904,723,1627,1631
2010,7,94,9420,PAPUA,KEEROM,3807,0,3302,505,0,34,36,168,126,87,85,70,64,390,393,0,0,364,172,134,783,0,0,1001,374,0,78,0,749,704,1453,1453
2010,7,94,9419,PAPUA,SARMI,0,0,0,0,0,0,0,0,0,0,0,0,0,0,0,0,0,0,0,0,0,0,0,0,0,0,0,0,0,0,0,0
2010,7,94,9409,PAPUA,BIAK NUMFOR,2811,0,1724,49,0,32,40,131,121,73,88,41,27,137,290,0,0,324,161,68,427,0,0,52,919,0,9,0,414,566,980,980
2010,7,94,9427,PAPUA,SUPIORI,1011,0,574,440,0,2,1,16,22,19,18,23,21,46,42,0,0,41,37,44,88,0,0,156,33,0,21,0,106,104,210,210
2010,7,94,9401,PAPUA,MERAUKE,920,0,560,313,0,7,17,27,33,27,24,19,17,62,54,0,0,84,51,36,116,0,0,6,278,0,3,0,142,145,287,287
2010,7,94,9414,PAPUA,MAPPI,1098,0,698,121,0,5,4,22,24,35,16,20,15,45,64,0,0,55,51,35,109,0,0,79,171,0,10,0,127,123,250,260
2010,7,94,9413,PAPUA,BOVEN DIGOEL,879,0,444,251,0,4,6,17,11,26,24,10,17,170,83,0,0,38,50,27,253,0,0,186,126,0,55,0,227,141,368,367
2010,7,94,9404,PAPUA,NABIRE,2704,0,2704,0,0,68,49,146,140,112,98,68,76,358,377,0,0,403,210,144,735,0,0,843,518,5,61,0,752,740,1492,1427
2010,7,94,9408,PAPUA,KEPULAUAN YAPEN,1697,0,1237,93,0,66,52,69,72,53,42,58,51,155,134,0,0,259,95,109,289,0,0,718,31,0,5,0,401,351,752,754
2010,7,94,9412,PAPUA,MIMIKA,8977,0,8828,324,0,58,54,287,298,249,217,159,178,1432,1230,0,0,697,466,337,2662,0,0,2370,1491,113,190,0,2185,1977,4162,4164
2010,7,94,9410,PAPUA,PANIAI,670,0,314,356,0,0,0,7,6,22,19,47,51,120,117,0,0,13,41,98,237,0,0,257,119,0,13,0,196,193,389,389
2010,7,94,9415,PAPUA,ASMAT,390,0,102,17,0,1,3,13,7,6,7,4,3,26,17,0,0,24,13,7,43,0,0,46,17,0,24,0,50,37,87,87
2010,7,94,9426,PAPUA,WAROPEN,0,0,0,0,0,0,0,0,0,0,0,0,0,0,0,0,0,0,0,0,0,0,0,0,0,0,0,0,0,0,0,0
2010,7,94,9402,PAPUA,JAYAWIJAYA,0,0,0,0,0,0,0,0,0,0,0,0,0,0,0,0,0,0,0,0,0,0,0,0,0,0,0,0,0,0,0,0
2010,7,94,9411,PAPUA,PUNCAK JAYA,0,0,0,0,0,0,0,0,0,0,0,0,0,0,0,0,0,0,0,0,0,0,0,0,0,0,0,0,0,0,0,0
2010,7,94,9418,PAPUA,TOLIKARA,0,0,0,0,0,0,0,0,0,0,0,0,0,0,0,0,0,0,0,0,0,0,0,0,0,0,0,0,0,0,0,0
2010,7,94,9416,PAPUA,YAHUKIMO,0,0,0,0,0,0,0,0,0,0,0,0,0,0,0,0,0,0,0,0,0,0,0,0,0,0,0,0,0,0,0,0
2010,7,94,9417,PAPUA,PEGUNUNGAN BINTANG,0,0,0,0,0,0,0,0,0,0,0,0,0,0,0,0,0,0,0,0,0,0,0,0,0,0,0,0,0,0,0,0
2010,8,94,9403,PAPUA,JAYAPURA,5405,0,3371,610,0,25,25,149,144,143,123,73,63,274,305,0,0,343,266,136,579,0,2,984,229,2,109,0,664,660,1324,1324
2010,8,94,9471,PAPUA,KOTA JAYAPURA,6420,0,5369,563,0,20,21,103,109,120,115,83,51,480,354,0,0,253,235,134,834,0,9,962,459,5,40,0,806,650,1456,1466
2010,8,94,9420,PAPUA,KEEROM,4229,0,3298,931,0,40,42,175,135,91,81,68,45,377,296,0,0,392,172,113,673,0,37,915,344,5,86,0,751,599,1350,1350
2010,8,94,9419,PAPUA,SARMI,0,0,0,0,0,0,0,0,0,0,0,0,0,0,0,0,0,0,0,0,0,0,0,0,0,0,0,0,0,0,0,0
2010,8,94,9409,PAPUA,BIAK NUMFOR,2790,0,1723,88,0,11,13,38,31,29,21,26,16,55,112,0,0,93,50,42,167,0,47,63,292,0,9,0,159,193,352,364
2010,8,94,9427,PAPUA,SUPIORI,522,0,359,135,0,1,0,4,5,10,4,3,4,23,9,0,0,10,14,7,32,0,0,45,5,0,13,0,41,22,63,63
2010,8,94,9401,PAPUA,MERAUKE,1508,0,718,787,0,8,14,34,23,13,26,17,12,60,54,0,0,79,39,29,114,0,0,13,245,0,3,0,132,129,261,261
2010,8,94,9414,PAPUA,MAPPI,1431,0,887,536,0,16,12,41,42,37,16,40,48,77,81,0,0,111,53,88,158,0,8,101,244,0,26,0,211,199,410,371
2010,8,94,9413,PAPUA,BOVEN DIGOEL,835,0,441,274,0,14,10,32,25,21,29,22,15,133,115,0,0,81,50,37,248,0,8,248,148,0,24,0,222,194,416,420
2010,8,94,9404,PAPUA,NABIRE,3605,0,3089,516,0,69,43,159,162,118,93,77,71,466,433,0,0,433,211,148,899,0,21,973,489,4,79,0,889,802,1691,1545
2010,8,94,9408,PAPUA,KEPULAUAN YAPEN,4749,0,2763,7,0,70,52,174,134,119,127,93,97,294,356,0,0,430,246,190,650,0,50,1255,129,0,44,0,750,766,1516,1428
2010,8,94,9412,PAPUA,MIMIKA,9121,0,8970,737,0,60,267,303,178,167,98,98,118,946,1008,0,0,808,265,216,1954,0,27,1685,1282,96,130,0,1574,1669,3243,3193
2010,8,94,9410,PAPUA,PANIAI,431,0,283,25,0,2,2,9,8,16,17,34,28,118,98,0,0,21,33,62,216,0,0,235,90,0,7,0,179,153,332,332
2010,8,94,9415,PAPUA,ASMAT,1977,0,420,271,0,15,9,34,16,57,67,43,44,215,191,0,0,74,124,87,406,0,0,682,8,0,1,0,364,327,691,691
2010,8,94,9426,PAPUA,WAROPEN,0,0,0,0,0,0,0,0,0,0,0,0,0,0,0,0,0,0,0,0,0,0,0,0,0,0,0,0,0,0,0,0
2010,8,94,9402,PAPUA,JAYAWIJAYA,0,0,0,0,0,0,0,0,0,0,0,0,0,0,0,0,0,0,0,0,0,0,0,0,0,0,0,0,0,0,0,0
2010,8,94,9411,PAPUA,PUNCAK JAYA,0,0,0,0,0,0,0,0,0,0,0,0,0,0,0,0,0,0,0,0,0,0,0,0,0,0,0,0,0,0,0,0
2010,8,94,9418,PAPUA,TOLIKARA,0,0,0,0,0,0,0,0,0,0,0,0,0,0,0,0,0,0,0,0,0,0,0,0,0,0,0,0,0,0,0,0
2010,8,94,9416,PAPUA,YAHUKIMO,0,0,0,0,0,0,0,0,0,0,0,0,0,0,0,0,0,0,0,0,0,0,0,0,0,0,0,0,0,0,0,0
2010,8,94,9417,PAPUA,PEGUNUNGAN BINTANG,0,0,0,0,0,0,0,0,0,0,0,0,0,0,0,0,0,0,0,0,0,0,0,0,0,0,0,0,0,0,0,0
2010,9,94,9403,PAPUA,JAYAPURA,5545,0,3315,589,0,33,22,146,123,121,139,78,66,255,299,0,0,324,260,144,554,0,1,962,239,2,79,0,633,649,1282,1282
2010,9,94,9471,PAPUA,KOTA JAYAPURA,6018,0,5117,975,0,11,10,82,85,95,89,69,64,446,311,0,0,188,184,133,757,0,7,829,398,2,37,0,703,559,1262,1266
2010,9,94,9420,PAPUA,KEEROM,3413,0,2811,602,0,18,11,123,74,71,57,34,39,271,184,0,0,226,128,73,455,0,2,631,191,0,60,0,517,365,882,882
2010,9,94,9419,PAPUA,SARMI,0,0,0,0,0,0,0,0,0,0,0,0,0,0,0,0,0,0,0,0,0,0,0,0,0,0,0,0,0,0,0,0
2010,9,94,9409,PAPUA,BIAK NUMFOR,1980,0,1206,111,0,9,10,32,36,22,8,20,7,33,52,0,0,87,30,27,85,0,36,46,184,0,8,0,116,113,229,238
2010,9,94,9427,PAPUA,SUPIORI,198,0,198,50,0,2,1,10,3,5,7,3,2,14,12,0,0,16,12,5,26,0,0,32,25,0,2,0,34,25,59,59
2010,9,94,9401,PAPUA,MERAUKE,1623,0,428,1104,0,11,14,26,27,29,34,14,12,56,46,0,0,78,63,26,102,0,0,25,217,0,3,0,136,133,269,245
2010,9,94,9414,PAPUA,MAPPI,1181,0,842,84,0,9,6,19,56,34,22,29,20,72,58,0,0,90,56,49,130,0,1,64,234,0,10,0,163,162,325,308
2010,9,94,9413,PAPUA,BOVEN DIGOEL,447,0,299,93,0,7,5,22,18,11,5,15,19,65,65,0,0,52,16,34,130,0,0,126,87,0,20,0,120,112,232,233
2010,9,94,9404,PAPUA,NABIRE,3114,0,2175,939,0,77,84,142,112,82,90,45,63,344,320,0,0,415,172,108,664,0,20,739,519,3,54,0,690,669,1359,1315
2010,9,94,9408,PAPUA,KEPULAUAN YAPEN,2047,0,1294,93,0,37,34,89,80,90,76,79,78,233,211,0,0,240,166,157,444,0,93,888,30,0,72,0,528,479,1007,990
2010,9,94,9412,PAPUA,MIMIKA,9842,0,9442,994,0,51,74,303,316,210,229,126,146,1169,1037,0,0,744,439,272,2206,0,11,1982,1411,106,156,0,1859,1802,3661,3655
2010,9,94,9410,PAPUA,PANIAI,462,0,266,196,0,0,0,4,4,7,8,24,23,94,111,0,0,8,15,47,205,0,0,126,78,0,11,0,129,146,275,215
2010,9,94,9415,PAPUA,ASMAT,599,0,146,198,0,2,5,9,15,11,29,20,36,81,136,0,0,31,40,56,217,0,0,344,0,0,0,0,123,221,344,344
2010,9,94,9426,PAPUA,WAROPEN,0,0,0,0,0,0,0,0,0,0,0,0,0,0,0,0,0,0,0,0,0,0,0,0,0,0,0,0,0,0,0,0
2010,9,94,9402,PAPUA,JAYAWIJAYA,0,0,0,0,0,0,0,0,0,0,0,0,0,0,0,0,0,0,0,0,0,0,0,0,0,0,0,0,0,0,0,0
2010,9,94,9411,PAPUA,PUNCAK JAYA,0,0,0,0,0,0,0,0,0,0,0,0,0,0,0,0,0,0,0,0,0,0,0,0,0,0,0,0,0,0,0,0
2010,9,94,9418,PAPUA,TOLIKARA,0,0,0,0,0,0,0,0,0,0,0,0,0,0,0,0,0,0,0,0,0,0,0,0,0,0,0,0,0,0,0,0
2010,9,94,9416,PAPUA,YAHUKIMO,0,0,0,0,0,0,0,0,0,0,0,0,0,0,0,0,0,0,0,0,0,0,0,0,0,0,0,0,0,0,0,0
2010,9,94,9417,PAPUA,PEGUNUNGAN BINTANG,0,0,0,0,0,0,0,0,0,0,0,0,0,0,0,0,0,0,0,0,0,0,0,0,0,0,0,0,0,0,0,0
2010,10,94,9403,PAPUA,JAYAPURA,5415,0,3530,493,0,22,23,174,158,130,127,77,66,232,291,0,0,377,257,143,523,0,0,1032,218,0,50,0,635,665,1300,1300
2010,10,94,9471,PAPUA,KOTA JAYAPURA,7723,0,4703,608,0,23,15,116,91,93,88,59,43,352,255,0,0,245,181,102,607,0,11,689,369,8,50,0,643,492,1135,1116
2010,10,94,9420,PAPUA,KEEROM,3740,0,3273,467,0,24,15,107,88,81,59,48,48,268,241,0,0,234,140,96,509,0,38,657,274,0,48,0,528,451,979,979
2010,10,94,9419,PAPUA,SARMI,0,0,0,0,0,0,0,0,0,0,0,0,0,0,0,0,0,0,0,0,0,0,0,0,0,0,0,0,0,0,0,0
2010,10,94,9409,PAPUA,BIAK NUMFOR,2626,0,1693,91,0,8,11,56,41,33,23,19,16,56,76,0,0,116,56,35,132,0,32,111,222,0,6,0,172,167,339,339
2010,10,94,9427,PAPUA,SUPIORI,297,0,228,69,0,0,1,5,1,1,3,5,10,15,8,0,0,7,4,15,23,0,0,27,21,0,1,0,26,23,49,49
2010,10,94,9401,PAPUA,MERAUKE,2065,0,1108,684,0,16,14,52,52,41,40,20,18,63,62,0,0,134,81,38,125,0,1,20,354,0,4,0,192,186,378,378
2010,10,94,9414,PAPUA,MAPPI,1377,0,1052,77,0,4,8,38,44,23,25,29,11,79,68,0,0,94,48,40,147,0,0,68,257,0,4,0,173,156,329,329
2010,10,94,9413,PAPUA,BOVEN DIGOEL,696,0,427,101,0,9,10,22,25,18,21,11,13,67,74,0,0,66,39,24,141,0,2,162,90,0,18,0,127,143,270,270
2010,10,94,9404,PAPUA,NABIRE,2034,0,1723,144,0,26,23,107,94,66,51,32,28,192,184,0,0,250,117,60,376,0,1,444,337,1,21,0,423,380,803,803
2010,10,94,9408,PAPUA,KEPULAUAN YAPEN,1817,0,1342,234,0,31,17,122,89,59,57,33,24,135,142,0,0,259,116,57,277,0,40,647,47,0,9,0,380,329,709,703
2010,10,94,9412,PAPUA,MIMIKA,10691,0,7944,769,0,36,23,164,171,164,158,109,137,867,776,0,0,394,322,246,1643,0,1,1156,1337,20,106,0,1340,1265,2605,2619
2010,10,94,9410,PAPUA,PANIAI,557,0,173,173,0,0,0,4,4,10,10,19,21,77,73,0,0,8,20,40,150,0,0,134,71,0,10,0,110,108,218,215
2010,10,94,9415,PAPUA,ASMAT,487,0,212,98,0,0,10,1,19,2,8,6,21,41,202,0,0,30,10,27,243,0,0,310,0,0,0,0,50,260,310,310
2010,10,94,9426,PAPUA,WAROPEN,0,0,0,0,0,0,0,0,0,0,0,0,0,0,0,0,0,0,0,0,0,0,0,0,0,0,0,0,0,0,0,0
2010,10,94,9402,PAPUA,JAYAWIJAYA,780,0,708,4,0,0,0,1,3,2,1,0,1,21,13,0,0,4,3,1,34,0,0,13,29,0,0,0,24,18,42,42
2010,10,94,9411,PAPUA,PUNCAK JAYA,0,0,0,0,0,0,0,0,0,0,0,0,0,0,0,0,0,0,0,0,0,0,0,0,0,0,0,0,0,0,0,0
2010,10,94,9418,PAPUA,TOLIKARA,0,0,0,0,0,0,0,0,0,0,0,0,0,0,0,0,0,0,0,0,0,0,0,0,0,0,0,0,0,0,0,0
2010,10,94,9416,PAPUA,YAHUKIMO,0,0,0,0,0,0,0,0,0,0,0,0,0,0,0,0,0,0,0,0,0,0,0,0,0,0,0,0,0,0,0,0
2010,10,94,9417,PAPUA,PEGUNUNGAN BINTANG,0,0,0,0,0,0,0,0,0,0,0,0,0,0,0,0,0,0,0,0,0,0,0,0,0,0,0,0,0,0,0,0
2010,11,94,9403,PAPUA,JAYAPURA,5781,0,3905,570,0,27,26,182,152,114,133,78,78,222,268,0,0,387,247,156,490,0,1,1003,245,0,32,0,623,657,1280,1280
2010,11,94,9471,PAPUA,KOTA JAYAPURA,6062,0,5115,612,0,13,19,100,66,90,75,76,70,348,288,0,0,198,165,146,636,0,12,716,365,11,53,0,627,518,1145,1145
2010,11,94,9420,PAPUA,KEEROM,3809,0,3412,397,0,24,12,127,107,61,93,49,63,360,260,0,0,270,154,112,620,0,13,820,284,0,52,0,621,535,1156,1156
2010,11,94,9419,PAPUA,SARMI,0,0,0,0,0,0,0,0,0,0,0,0,0,0,0,0,0,0,0,0,0,0,0,0,0,0,0,0,0,0,0,0
2010,11,94,9409,PAPUA,BIAK NUMFOR,2411,0,1483,89,0,19,11,32,39,26,20,12,10,54,65,0,0,101,46,22,119,0,47,54,227,0,16,0,143,145,288,297
2010,11,94,9427,PAPUA,SUPIORI,335,0,295,40,0,0,0,3,1,3,0,7,0,18,8,0,0,4,3,7,26,0,0,27,10,0,3,0,31,9,40,40
2010,11,94,9401,PAPUA,MERAUKE,2552,0,1511,822,0,18,16,64,63,69,58,34,45,96,70,0,0,161,127,79,166,0,0,14,519,0,0,0,281,252,533,533
2010,11,94,9414,PAPUA,MAPPI,1449,0,1160,201,0,9,15,42,49,36,39,29,13,73,46,0,0,115,75,42,119,0,0,65,284,0,2,0,189,162,351,351
2010,11,94,9413,PAPUA,BOVEN DIGOEL,1177,0,578,369,0,10,11,46,157,33,26,18,19,102,124,0,0,224,59,37,226,0,0,247,283,0,16,0,209,337,546,546
2010,11,94,9404,PAPUA,NABIRE,1671,0,1197,203,0,6,3,29,44,26,22,16,23,92,51,0,0,82,48,39,143,0,2,203,85,1,26,0,169,143,312,315
2010,11,94,9408,PAPUA,KEPULAUAN YAPEN,1910,0,1198,240,0,28,25,106,88,88,76,84,58,112,174,0,0,247,164,142,286,0,52,675,71,0,49,0,418,421,839,795
2010,11,94,9412,PAPUA,MIMIKA,15857,0,14396,430,0,79,66,441,456,319,307,189,175,1515,1386,0,0,1042,626,364,2901,0,45,2184,2473,108,161,0,2543,2390,4933,4926
2010,11,94,9410,PAPUA,PANIAI,366,0,165,190,0,0,0,3,3,7,6,14,16,94,87,0,0,6,13,30,181,0,0,108,128,0,9,0,118,112,230,245
2010,11,94,9415,PAPUA,ASMAT,915,0,209,288,0,21,11,56,33,61,55,57,42,111,50,0,0,121,116,99,161,0,0,356,112,0,9,0,306,191,497,477
2010,11,94,9426,PAPUA,WAROPEN,0,0,0,0,0,0,0,0,0,0,0,0,0,0,0,0,0,0,0,0,0,0,0,0,0,0,0,0,0,0,0,0
2010,11,94,9402,PAPUA,JAYAWIJAYA,480,0,476,2,0,0,0,1,3,2,0,1,0,19,14,0,0,4,2,1,33,0,0,20,20,0,0,0,23,17,40,40
2010,11,94,9411,PAPUA,PUNCAK JAYA,0,0,0,0,0,0,0,0,0,0,0,0,0,0,0,0,0,0,0,0,0,0,0,0,0,0,0,0,0,0,0,0
2010,11,94,9418,PAPUA,TOLIKARA,0,0,0,0,0,0,0,0,0,0,0,0,0,0,0,0,0,0,0,0,0,0,0,0,0,0,0,0,0,0,0,0
2010,11,94,9416,PAPUA,YAHUKIMO,0,0,0,0,0,0,0,0,0,0,0,0,0,0,0,0,0,0,0,0,0,0,0,0,0,0,0,0,0,0,0,0
2010,11,94,9417,PAPUA,PEGUNUNGAN BINTANG,0,0,0,0,0,0,0,0,0,0,0,0,0,0,0,0,0,0,0,0,0,0,0,0,0,0,0,0,0,0,0,0
2010,12,94,9403,PAPUA,JAYAPURA,4810,0,2823,634,0,29,15,176,172,109,103,73,84,236,287,0,0,392,212,157,523,0,2,935,281,12,56,0,623,661,1284,1284
2010,12,94,9471,PAPUA,KOTA JAYAPURA,4483,0,3322,910,0,22,7,40,48,35,41,43,24,170,139,0,0,117,76,67,309,0,7,366,165,4,34,0,310,259,569,569
2010,12,94,9420,PAPUA,KEEROM,3120,0,2929,191,0,27,18,112,82,65,58,37,29,315,196,0,0,239,123,66,511,0,8,611,278,1,49,0,556,383,939,939
2010,12,94,9419,PAPUA,SARMI,0,0,0,0,0,0,0,0,0,0,0,0,0,0,0,0,0,0,0,0,0,0,0,0,0,0,0,0,0,0,0,0
2010,12,94,9409,PAPUA,BIAK NUMFOR,204,0,93,2,0,1,0,1,5,4,0,0,0,2,7,0,0,7,4,0,9,0,2,0,21,0,0,0,8,12,20,21
2010,12,94,9427,PAPUA,SUPIORI,251,0,186,5,0,2,1,2,3,2,6,3,4,10,9,0,0,8,8,7,19,0,0,34,8,0,0,0,19,23,42,42
2010,12,94,9401,PAPUA,MERAUKE,1010,0,572,229,0,14,11,35,39,37,39,17,26,76,86,0,0,99,76,43,162,0,0,24,356,0,0,0,179,201,380,380
2010,12,94,9414,PAPUA,MAPPI,791,0,547,198,0,11,5,37,35,34,21,13,6,49,40,0,0,88,55,19,89,0,0,34,195,0,22,0,144,107,251,251
2010,12,94,9413,PAPUA,BOVEN DIGOEL,819,0,344,177,0,1,4,18,11,14,4,9,24,83,36,0,0,34,18,33,119,0,0,117,75,0,11,0,125,79,204,203
2010,12,94,9404,PAPUA,NABIRE,2409,0,2013,56,0,68,31,142,125,55,38,30,28,487,516,0,0,366,93,58,1003,0,3,158,86,0,28,0,782,738,1520,272
2010,12,94,9408,PAPUA,KEPULAUAN YAPEN,1022,0,952,70,0,21,17,32,27,21,32,23,24,117,95,0,0,97,53,47,212,0,28,393,15,0,1,0,214,195,409,409
2010,12,94,9412,PAPUA,MIMIKA,12077,0,11090,492,0,57,47,305,284,231,224,153,134,1318,1153,0,0,693,455,287,2471,0,0,1779,1861,90,156,0,2064,1842,3906,3886
2010,12,94,9410,PAPUA,PANIAI,244,0,148,92,0,0,0,3,2,5,5,10,10,42,42,0,0,5,10,20,84,0,0,0,0,0,0,0,60,59,119,0
2010,12,94,9415,PAPUA,ASMAT,736,0,197,201,0,21,12,31,14,41,21,20,29,134,75,0,0,78,62,49,209,0,0,0,0,0,0,0,247,151,398,0
2010,12,94,9426,PAPUA,WAROPEN,0,0,0,0,0,0,0,0,0,0,0,0,0,0,0,0,0,0,0,0,0,0,0,0,0,0,0,0,0,0,0,0
2010,12,94,9402,PAPUA,JAYAWIJAYA,0,0,0,0,0,0,0,0,0,0,0,0,0,0,0,0,0,0,0,0,0,0,0,0,0,0,0,0,0,0,0,0
2010,12,94,9411,PAPUA,PUNCAK JAYA,0,0,0,0,0,0,0,0,0,0,0,0,0,0,0,0,0,0,0,0,0,0,0,0,0,0,0,0,0,0,0,0
2010,12,94,9418,PAPUA,TOLIKARA,0,0,0,0,0,0,0,0,0,0,0,0,0,0,0,0,0,0,0,0,0,0,0,0,0,0,0,0,0,0,0,0
2010,12,94,9416,PAPUA,YAHUKIMO,0,0,0,0,0,0,0,0,0,0,0,0,0,0,0,0,0,0,0,0,0,0,0,0,0,0,0,0,0,0,0,0
2010,12,94,9417,PAPUA,PEGUNUNGAN BINTANG,0,0,0,0,0,0,0,0,0,0,0,0,0,0,0,0,0,0,0,0,0,0,0,0,0,0,0,0,0,0,0,0
2011,1,91,9171,PAPUA BARAT,KOTA SORONG,0,0,0,0,0,0,0,0,0,0,0,0,0,0,0,0,0,0,0,0,0,0,0,0,0,0,0,0,0,0,0,0
2011,1,91,9107,PAPUA BARAT,SORONG,0,0,0,0,0,0,0,0,0,0,0,0,0,0,0,0,0,0,0,0,0,0,0,0,0,0,0,0,0,0,0,0
2011,1,91,9106,PAPUA BARAT,SORONG SELATAN,0,0,0,0,0,0,0,0,0,0,0,0,0,0,0,0,0,0,0,0,0,0,0,0,0,0,0,0,0,0,0,0
2011,1,91,9108,PAPUA BARAT,RAJA AMPAT,0,0,0,0,0,0,0,0,0,0,0,0,0,0,0,0,0,0,0,0,0,0,0,0,0,0,0,0,0,0,0,0
2011,1,91,9105,PAPUA BARAT,MANOKWARI,0,0,0,0,0,0,0,0,0,0,0,0,0,0,0,0,0,0,0,0,0,0,0,0,0,0,0,0,0,0,0,0
2011,1,91,9104,PAPUA BARAT,TELUK BINTUNI,0,0,0,0,0,0,0,0,0,0,0,0,0,0,0,0,0,0,0,0,0,0,0,0,0,0,0,0,0,0,0,0
2011,1,91,9103,PAPUA BARAT,TELUK WONDAMA,0,0,0,0,0,0,0,0,0,0,0,0,0,0,0,0,0,0,0,0,0,0,0,0,0,0,0,0,0,0,0,0
2011,1,91,9101,PAPUA BARAT,FAKFAK,0,0,0,0,0,0,0,0,0,0,0,0,0,0,0,0,0,0,0,0,0,0,0,0,0,0,0,0,0,0,0,0
2011,1,91,9102,PAPUA BARAT,KAIMANA,0,0,0,0,0,0,0,0,0,0,0,0,0,0,0,0,0,0,0,0,0,0,0,0,0,0,0,0,0,0,0,0
2011,1,94,9403,PAPUA,JAYAPURA,7678,0,4758,889,0,26,29,238,196,215,230,114,110,391,456,0,0,489,445,224,847,0,3,1477,372,4,92,0,984,1021,2005,1945
2011,1,94,9471,PAPUA,KOTA JAYAPURA,6485,0,5722,678,0,20,12,99,87,103,87,69,54,422,298,0,0,218,190,123,720,0,0,725,495,5,34,0,713,538,1251,1259
2011,1,94,9420,PAPUA,KEEROM,4198,0,3804,394,0,16,15,105,105,74,61,44,46,435,206,0,0,241,135,90,641,0,20,738,307,3,59,0,674,433,1107,1107
2011,1,94,9419,PAPUA,SARMI,0,0,0,0,0,0,0,0,0,0,0,0,0,0,0,0,0,0,0,0,0,0,0,0,0,0,0,0,0,0,0,0
2011,1,94,9409,PAPUA,BIAK NUMFOR,3782,0,1899,1409,0,18,30,125,92,74,73,67,55,134,156,0,0,265,147,122,290,0,0,275,438,0,111,0,418,406,824,824
2011,1,94,9427,PAPUA,SUPIORI,356,0,33,33,0,0,0,9,7,1,3,1,3,9,13,0,0,16,4,4,22,0,0,29,13,0,6,0,20,26,46,48
2011,1,94,9401,PAPUA,MERAUKE,893,0,378,418,0,5,3,21,14,19,24,18,12,53,58,0,0,43,43,30,111,0,0,25,199,0,3,0,116,111,227,227
2011,1,94,9414,PAPUA,MAPPI,765,0,624,113,0,12,11,38,30,22,12,14,27,74,60,0,0,91,34,41,134,0,12,37,253,0,4,0,160,140,300,294
2011,1,94,9413,PAPUA,BOVEN DIGOEL,715,0,435,56,0,0,11,29,24,28,15,10,10,98,111,0,0,64,43,20,209,0,0,223,99,0,10,0,165,171,336,332
2011,1,94,9404,PAPUA,NABIRE,4363,0,2895,194,0,96,69,176,148,94,106,53,72,599,600,0,0,489,200,125,1199,0,16,1247,716,11,24,0,1018,995,2013,1998
2011,1,94,9408,PAPUA,KEPULAUAN YAPEN,1544,0,1155,14,0,20,20,36,57,39,52,41,58,119,134,0,0,133,91,99,253,0,104,550,21,0,1,0,255,321,576,572
2011,1,94,9412,PAPUA,MIMIKA,11128,0,7171,880,0,58,51,309,267,246,208,201,164,1147,934,0,0,685,454,365,2081,0,0,1514,1742,119,232,0,1961,1624,3585,3607
2011,1,94,9410,PAPUA,PANIAI,1727,0,334,643,0,11,82,82,151,143,137,203,82,111,24,0,0,326,280,285,135,0,6,521,320,0,167,0,550,476,1026,1008
2011,1,94,9415,PAPUA,ASMAT,1248,0,217,431,0,8,43,43,46,27,26,19,28,81,70,0,0,140,53,47,151,0,0,242,97,0,18,0,178,213,391,357
2011,1,94,9426,PAPUA,WAROPEN,146,0,146,0,0,3,14,14,11,7,2,4,4,24,6,0,0,42,9,8,30,0,0,89,6,0,0,0,52,37,89,95
2011,1,94,9402,PAPUA,JAYAWIJAYA,698,0,650,48,0,4,12,12,7,8,5,8,7,45,50,0,0,35,13,15,95,0,0,72,75,0,1,0,77,81,158,148
2011,1,94,9411,PAPUA,PUNCAK JAYA,0,0,0,0,0,0,0,0,0,0,0,0,0,0,0,0,0,0,0,0,0,0,0,0,0,0,0,0,0,0,0,0
2011,1,94,9418,PAPUA,TOLIKARA,0,0,0,0,0,0,0,0,0,0,0,0,0,0,0,0,0,0,0,0,0,0,0,0,0,0,0,0,0,0,0,0
2011,1,94,9416,PAPUA,YAHUKIMO,0,0,0,0,0,0,0,0,0,0,0,0,0,0,0,0,0,0,0,0,0,0,0,0,0,0,0,0,0,0,0,0
2011,1,94,9417,PAPUA,PEGUNUNGAN BINTANG,0,0,0,0,0,0,0,0,0,0,0,0,0,0,0,0,0,0,0,0,0,0,0,0,0,0,0,0,0,0,0,0
2011,2,91,9171,PAPUA BARAT,KOTA SORONG,0,0,0,0,0,0,0,0,0,0,0,0,0,0,0,0,0,0,0,0,0,0,0,0,0,0,0,0,0,0,0,0
2011,2,91,9107,PAPUA BARAT,SORONG,0,0,0,0,0,0,0,0,0,0,0,0,0,0,0,0,0,0,0,0,0,0,0,0,0,0,0,0,0,0,0,0
2011,2,91,9106,PAPUA BARAT,SORONG SELATAN,0,0,0,0,0,0,0,0,0,0,0,0,0,0,0,0,0,0,0,0,0,0,0,0,0,0,0,0,0,0,0,0
2011,2,91,9108,PAPUA BARAT,RAJA AMPAT,0,0,0,0,0,0,0,0,0,0,0,0,0,0,0,0,0,0,0,0,0,0,0,0,0,0,0,0,0,0,0,0
2011,2,91,9105,PAPUA BARAT,MANOKWARI,0,0,0,0,0,0,0,0,0,0,0,0,0,0,0,0,0,0,0,0,0,0,0,0,0,0,0,0,0,0,0,0
2011,2,91,9104,PAPUA BARAT,TELUK BINTUNI,0,0,0,0,0,0,0,0,0,0,0,0,0,0,0,0,0,0,0,0,0,0,0,0,0,0,0,0,0,0,0,0
2011,2,91,9103,PAPUA BARAT,TELUK WONDAMA,0,0,0,0,0,0,0,0,0,0,0,0,0,0,0,0,0,0,0,0,0,0,0,0,0,0,0,0,0,0,0,0
2011,2,91,9101,PAPUA BARAT,FAKFAK,0,0,0,0,0,0,0,0,0,0,0,0,0,0,0,0,0,0,0,0,0,0,0,0,0,0,0,0,0,0,0,0
2011,2,91,9102,PAPUA BARAT,KAIMANA,0,0,0,0,0,0,0,0,0,0,0,0,0,0,0,0,0,0,0,0,0,0,0,0,0,0,0,0,0,0,0,0
2011,2,94,9403,PAPUA,JAYAPURA,8564,0,5595,817,0,20,22,0,212,229,215,143,168,626,648,0,0,254,444,311,1274,0,0,1596,435,14,142,0,1018,1265,2283,2187
2011,2,94,9471,PAPUA,KOTA JAYAPURA,5362,0,4477,803,0,15,16,70,92,122,86,68,71,390,306,0,0,193,208,139,696,0,11,717,476,10,39,0,665,571,1236,1242
2011,2,94,9420,PAPUA,KEEROM,3354,0,3144,210,0,24,20,104,108,97,93,43,50,305,199,0,0,256,190,93,504,0,5,700,302,2,54,0,573,470,1043,1058
2011,2,94,9419,PAPUA,SARMI,0,0,0,0,0,0,0,0,0,0,0,0,0,0,0,0,0,0,0,0,0,0,0,0,0,0,0,0,0,0,0,0
2011,2,94,9409,PAPUA,BIAK NUMFOR,1393,0,1079,165,0,9,12,64,43,27,31,15,14,34,70,0,0,128,58,29,104,0,33,84,234,0,1,0,149,170,319,319
2011,2,94,9427,PAPUA,SUPIORI,315,0,123,76,0,2,1,8,8,4,1,3,2,10,15,0,0,19,5,5,25,0,0,26,26,0,3,0,27,27,54,55
2011,2,94,9401,PAPUA,MERAUKE,792,0,267,320,0,12,2,23,33,21,16,11,12,59,43,0,0,70,37,23,102,0,0,23,207,0,2,0,126,106,232,232
2011,2,94,9414,PAPUA,MAPPI,902,0,777,77,0,14,15,32,39,27,16,12,13,57,62,0,0,100,43,25,119,0,1,33,250,0,7,0,142,145,287,290
2011,2,94,9413,PAPUA,BOVEN DIGOEL,684,0,406,138,0,10,5,30,22,25,36,12,13,75,126,0,0,67,61,25,201,0,1,228,123,0,13,0,152,202,354,364
2011,2,94,9404,PAPUA,NABIRE,4495,0,2800,260,0,74,45,179,147,108,98,74,79,307,311,0,0,445,206,153,618,0,4,1037,328,0,57,0,742,680,1422,1422
2011,2,94,9408,PAPUA,KEPULAUAN YAPEN,1289,0,1038,78,0,33,23,49,35,35,24,20,26,44,110,0,0,140,59,46,154,0,26,378,17,0,4,0,181,218,399,399
2011,2,94,9412,PAPUA,MIMIKA,6739,0,4472,922,0,21,23,118,118,106,120,84,61,764,586,0,0,280,226,145,1350,0,8,953,919,15,114,0,1093,908,2001,2001
2011,2,94,9410,PAPUA,PANIAI,478,0,158,154,0,0,0,4,4,10,10,18,20,66,61,0,0,8,20,38,127,0,0,117,67,0,9,0,98,95,193,193
2011,2,94,9415,PAPUA,ASMAT,403,0,225,146,0,2,2,12,14,15,10,15,6,34,23,0,0,30,25,21,57,0,1,69,56,0,8,0,78,55,133,133
2011,2,94,9426,PAPUA,WAROPEN,433,0,433,0,0,1,3,13,13,11,9,5,5,34,47,0,0,30,20,10,81,0,8,140,8,0,0,0,64,77,141,148
2011,2,94,9402,PAPUA,JAYAWIJAYA,793,0,766,27,0,3,0,15,18,17,7,15,17,68,49,0,0,36,24,32,117,0,0,57,151,0,1,0,118,91,209,209
2011,2,94,9411,PAPUA,PUNCAK JAYA,0,0,0,0,0,0,0,0,0,0,0,0,0,0,0,0,0,0,0,0,0,0,0,0,0,0,0,0,0,0,0,0
2011,2,94,9418,PAPUA,TOLIKARA,0,0,0,0,0,0,0,0,0,0,0,0,0,0,0,0,0,0,0,0,0,0,0,0,0,0,0,0,0,0,0,0
2011,2,94,9416,PAPUA,YAHUKIMO,0,0,0,0,0,0,0,0,0,0,0,0,0,0,0,0,0,0,0,0,0,0,0,0,0,0,0,0,0,0,0,0
2011,2,94,9417,PAPUA,PEGUNUNGAN BINTANG,0,0,0,0,0,0,0,0,0,0,0,0,0,0,0,0,0,0,0,0,0,0,0,0,0,0,0,0,0,0,0,0
2011,3,91,9171,PAPUA BARAT,KOTA SORONG,0,0,0,0,0,0,0,0,0,0,0,0,0,0,0,0,0,0,0,0,0,0,0,0,0,0,0,0,0,0,0,0
2011,3,91,9107,PAPUA BARAT,SORONG,0,0,0,0,0,0,0,0,0,0,0,0,0,0,0,0,0,0,0,0,0,0,0,0,0,0,0,0,0,0,0,0
2011,3,91,9106,PAPUA BARAT,SORONG SELATAN,0,0,0,0,0,0,0,0,0,0,0,0,0,0,0,0,0,0,0,0,0,0,0,0,0,0,0,0,0,0,0,0
2011,3,91,9108,PAPUA BARAT,RAJA AMPAT,0,0,0,0,0,0,0,0,0,0,0,0,0,0,0,0,0,0,0,0,0,0,0,0,0,0,0,0,0,0,0,0
2011,3,91,9105,PAPUA BARAT,MANOKWARI,0,0,0,0,0,0,0,0,0,0,0,0,0,0,0,0,0,0,0,0,0,0,0,0,0,0,0,0,0,0,0,0
2011,3,91,9104,PAPUA BARAT,TELUK BINTUNI,0,0,0,0,0,0,0,0,0,0,0,0,0,0,0,0,0,0,0,0,0,0,0,0,0,0,0,0,0,0,0,0
2011,3,91,9103,PAPUA BARAT,TELUK WONDAMA,0,0,0,0,0,0,0,0,0,0,0,0,0,0,0,0,0,0,0,0,0,0,0,0,0,0,0,0,0,0,0,0
2011,3,91,9101,PAPUA BARAT,FAKFAK,0,0,0,0,0,0,0,0,0,0,0,0,0,0,0,0,0,0,0,0,0,0,0,0,0,0,0,0,0,0,0,0
2011,3,91,9102,PAPUA BARAT,KAIMANA,0,0,0,0,0,0,0,0,0,0,0,0,0,0,0,0,0,0,0,0,0,0,0,0,0,0,0,0,0,0,0,0
2011,3,94,9403,PAPUA,JAYAPURA,7190,0,4099,995,0,17,28,226,171,221,186,121,139,389,538,0,0,442,407,260,927,0,0,1511,376,0,209,0,974,1062,2036,2096
2011,3,94,9471,PAPUA,KOTA JAYAPURA,4516,0,3963,455,0,14,13,86,68,59,68,57,47,353,294,0,0,181,127,104,647,0,15,642,399,7,37,0,569,490,1059,1085
2011,3,94,9420,PAPUA,KEEROM,5025,0,4217,248,0,34,20,185,151,145,106,73,68,526,375,0,0,390,251,141,901,0,10,1109,443,2,144,0,963,720,1683,1698
2011,3,94,9419,PAPUA,SARMI,0,0,0,0,0,0,0,0,0,0,0,0,0,0,0,0,0,0,0,0,0,0,0,0,0,0,0,0,0,0,0,0
2011,3,94,9409,PAPUA,BIAK NUMFOR,4074,0,1668,402,0,7,9,70,66,68,51,35,35,110,128,0,0,152,119,70,238,0,16,132,348,0,105,0,290,289,579,585
2011,3,94,9427,PAPUA,SUPIORI,0,0,0,0,0,0,0,0,0,0,0,0,0,0,0,0,0,0,0,0,0,0,0,0,0,0,0,0,0,0,0,0
2011,3,94,9401,PAPUA,MERAUKE,0,0,0,0,0,0,0,0,0,0,0,0,0,0,0,0,0,0,0,0,0,0,0,0,0,0,0,0,0,0,0,0
2011,3,94,9414,PAPUA,MAPPI,0,0,0,0,0,0,0,0,0,0,0,0,0,0,0,0,0,0,0,0,0,0,0,0,0,0,0,0,0,0,0,0
2011,3,94,9413,PAPUA,BOVEN DIGOEL,0,0,0,0,0,0,0,0,0,0,0,0,0,0,0,0,0,0,0,0,0,0,0,0,0,0,0,0,0,0,0,0
2011,3,94,9404,PAPUA,NABIRE,0,0,0,0,0,0,0,0,0,0,0,0,0,0,0,0,0,0,0,0,0,0,0,0,0,0,0,0,0,0,0,0
2011,3,94,9408,PAPUA,KEPULAUAN YAPEN,0,0,0,0,0,0,0,0,0,0,0,0,0,0,0,0,0,0,0,0,0,0,0,0,0,0,0,0,0,0,0,0
2011,3,94,9412,PAPUA,MIMIKA,18116,0,9640,1104,0,52,53,281,283,221,211,174,171,1229,1070,0,0,669,432,345,2299,0,143,1557,1715,102,252,0,1957,1788,3745,3626
2011,3,94,9410,PAPUA,PANIAI,637,0,179,299,0,1,1,4,4,9,10,21,18,119,110,0,0,10,19,39,229,0,0,102,199,0,13,0,154,143,297,314
2011,3,94,9415,PAPUA,ASMAT,1190,0,174,178,0,14,6,41,30,21,17,20,10,95,76,0,0,91,38,30,171,0,5,173,93,0,41,0,191,139,330,307
2011,3,94,9426,PAPUA,WAROPEN,378,0,378,0,0,8,11,22,32,28,20,17,7,77,119,0,0,73,48,24,196,0,10,298,35,0,0,0,152,189,341,333
2011,3,94,9402,PAPUA,JAYAWIJAYA,0,0,0,0,0,0,0,0,0,0,0,0,0,0,0,0,0,0,0,0,0,0,0,0,0,0,0,0,0,0,0,0
2011,3,94,9411,PAPUA,PUNCAK JAYA,0,0,0,0,0,0,0,0,0,0,0,0,0,0,0,0,0,0,0,0,0,0,0,0,0,0,0,0,0,0,0,0
2011,3,94,9418,PAPUA,TOLIKARA,0,0,0,0,0,0,0,0,0,0,0,0,0,0,0,0,0,0,0,0,0,0,0,0,0,0,0,0,0,0,0,0
2011,3,94,9416,PAPUA,YAHUKIMO,0,0,0,0,0,0,0,0,0,0,0,0,0,0,0,0,0,0,0,0,0,0,0,0,0,0,0,0,0,0,0,0
2011,3,94,9417,PAPUA,PEGUNUNGAN BINTANG,0,0,0,0,0,0,0,0,0,0,0,0,0,0,0,0,0,0,0,0,0,0,0,0,0,0,0,0,0,0,0,0
2011,4,91,9171,PAPUA BARAT,KOTA SORONG,0,0,0,0,0,0,0,0,0,0,0,0,0,0,0,0,0,0,0,0,0,0,0,0,0,0,0,0,0,0,0,0
2011,4,91,9107,PAPUA BARAT,SORONG,0,0,0,0,0,0,0,0,0,0,0,0,0,0,0,0,0,0,0,0,0,0,0,0,0,0,0,0,0,0,0,0
2011,4,91,9106,PAPUA BARAT,SORONG SELATAN,0,0,0,0,0,0,0,0,0,0,0,0,0,0,0,0,0,0,0,0,0,0,0,0,0,0,0,0,0,0,0,0
2011,4,91,9108,PAPUA BARAT,RAJA AMPAT,0,0,0,0,0,0,0,0,0,0,0,0,0,0,0,0,0,0,0,0,0,0,0,0,0,0,0,0,0,0,0,0
2011,4,91,9105,PAPUA BARAT,MANOKWARI,0,0,0,0,0,0,0,0,0,0,0,0,0,0,0,0,0,0,0,0,0,0,0,0,0,0,0,0,0,0,0,0
2011,4,91,9104,PAPUA BARAT,TELUK BINTUNI,0,0,0,0,0,0,0,0,0,0,0,0,0,0,0,0,0,0,0,0,0,0,0,0,0,0,0,0,0,0,0,0
2011,4,91,9103,PAPUA BARAT,TELUK WONDAMA,0,0,0,0,0,0,0,0,0,0,0,0,0,0,0,0,0,0,0,0,0,0,0,0,0,0,0,0,0,0,0,0
2011,4,91,9101,PAPUA BARAT,FAKFAK,0,0,0,0,0,0,0,0,0,0,0,0,0,0,0,0,0,0,0,0,0,0,0,0,0,0,0,0,0,0,0,0
2011,4,91,9102,PAPUA BARAT,KAIMANA,0,0,0,0,0,0,0,0,0,0,0,0,0,0,0,0,0,0,0,0,0,0,0,0,0,0,0,0,0,0,0,0
2011,4,94,9403,PAPUA,JAYAPURA,8582,0,5158,1200,0,0,0,0,0,0,0,0,0,0,0,0,0,0,0,0,0,0,0,1527,400,3,279,0,0,0,0,2209
2011,4,94,9471,PAPUA,KOTA JAYAPURA,10808,0,4562,797,0,0,0,0,0,0,0,0,0,0,0,0,0,0,0,0,0,0,13,922,443,6,81,0,0,0,0,1452
2011,4,94,9420,PAPUA,KEEROM,3236,0,2708,528,0,0,0,0,0,0,0,0,0,0,0,0,0,0,0,0,0,0,18,171,25382,0,133,0,0,0,0,25686
2011,4,94,9419,PAPUA,SARMI,0,0,0,0,0,0,0,0,0,0,0,0,0,0,0,0,0,0,0,0,0,0,0,0,0,0,0,0,0,0,0,0
2011,4,94,9409,PAPUA,BIAK NUMFOR,2056,0,1521,231,0,0,0,0,0,0,0,0,0,0,0,0,0,0,0,0,0,0,0,78,248,0,72,0,0,0,0,398
2011,4,94,9427,PAPUA,SUPIORI,239,0,81,71,0,0,0,0,0,0,0,0,0,0,0,0,0,0,0,0,0,0,0,38,36,0,19,0,0,0,0,93
2011,4,94,9401,PAPUA,MERAUKE,1083,0,399,263,0,0,0,0,0,0,0,0,0,0,0,0,0,0,0,0,0,0,0,8,208,0,2,0,0,0,0,218
2011,4,94,9414,PAPUA,MAPPI,1819,0,1056,715,0,0,0,0,0,0,0,0,0,0,0,0,0,0,0,0,0,0,0,96,371,1,13,0,0,0,0,481
2011,4,94,9413,PAPUA,BOVEN DIGOEL,762,0,371,204,0,0,0,0,0,0,0,0,0,0,0,0,0,0,0,0,0,0,22,103,76,0,127,0,0,0,0,306
2011,4,94,9404,PAPUA,NABIRE,4637,0,2899,271,0,0,0,0,0,0,0,0,0,0,0,0,0,0,0,0,0,0,3,1331,284,4,61,0,0,0,0,1680
2011,4,94,9408,PAPUA,KEPULAUAN YAPEN,3217,0,1265,437,0,0,0,0,0,0,0,0,0,0,0,0,0,0,0,0,0,0,46,558,38,0,37,0,0,0,0,633
2011,4,94,9412,PAPUA,MIMIKA,14535,0,12968,1293,0,0,0,0,0,0,0,0,0,0,0,0,0,0,0,0,0,0,60,2366,2197,140,211,0,0,0,0,4914
2011,4,94,9410,PAPUA,PANIAI,938,0,199,427,0,0,0,0,0,0,0,0,0,0,0,0,0,0,0,0,0,0,9,279,143,0,29,0,0,0,0,451
2011,4,94,9415,PAPUA,ASMAT,528,0,165,147,0,0,0,0,0,0,0,0,0,0,0,0,0,0,0,0,0,0,2,1394,20,0,22,0,0,0,0,1436
2011,4,94,9426,PAPUA,WAROPEN,458,0,458,0,0,0,0,0,0,0,0,0,0,0,0,0,0,0,0,0,0,0,4,277,32,0,0,0,0,0,0,309
2011,4,94,9402,PAPUA,JAYAWIJAYA,867,0,807,60,0,0,0,0,0,0,0,0,0,0,0,0,0,0,0,0,0,0,0,58,105,0,0,0,0,0,0,163
2011,4,94,9411,PAPUA,PUNCAK JAYA,0,0,0,0,0,0,0,0,0,0,0,0,0,0,0,0,0,0,0,0,0,0,0,0,0,0,0,0,0,0,0,0
2011,4,94,9418,PAPUA,TOLIKARA,0,0,0,0,0,0,0,0,0,0,0,0,0,0,0,0,0,0,0,0,0,0,0,0,0,0,0,0,0,0,0,0
2011,4,94,9416,PAPUA,YAHUKIMO,0,0,0,0,0,0,0,0,0,0,0,0,0,0,0,0,0,0,0,0,0,0,0,0,0,0,0,0,0,0,0,0
2011,4,94,9417,PAPUA,PEGUNUNGAN BINTANG,0,0,0,0,0,0,0,0,0,0,0,0,0,0,0,0,0,0,0,0,0,0,0,0,0,0,0,0,0,0,0,0
2011,5,91,9171,PAPUA BARAT,KOTA SORONG,0,0,0,0,0,0,0,0,0,0,0,0,0,0,0,0,0,0,0,0,0,0,0,0,0,0,0,0,0,0,0,0
2011,5,91,9107,PAPUA BARAT,SORONG,0,0,0,0,0,0,0,0,0,0,0,0,0,0,0,0,0,0,0,0,0,0,0,0,0,0,0,0,0,0,0,0
2011,5,91,9106,PAPUA BARAT,SORONG SELATAN,0,0,0,0,0,0,0,0,0,0,0,0,0,0,0,0,0,0,0,0,0,0,0,0,0,0,0,0,0,0,0,0
2011,5,91,9108,PAPUA BARAT,RAJA AMPAT,0,0,0,0,0,0,0,0,0,0,0,0,0,0,0,0,0,0,0,0,0,0,0,0,0,0,0,0,0,0,0,0
2011,5,91,9105,PAPUA BARAT,MANOKWARI,0,0,0,0,0,0,0,0,0,0,0,0,0,0,0,0,0,0,0,0,0,0,0,0,0,0,0,0,0,0,0,0
2011,5,91,9104,PAPUA BARAT,TELUK BINTUNI,0,0,0,0,0,0,0,0,0,0,0,0,0,0,0,0,0,0,0,0,0,0,0,0,0,0,0,0,0,0,0,0
2011,5,91,9103,PAPUA BARAT,TELUK WONDAMA,0,0,0,0,0,0,0,0,0,0,0,0,0,0,0,0,0,0,0,0,0,0,0,0,0,0,0,0,0,0,0,0
2011,5,91,9101,PAPUA BARAT,FAKFAK,0,0,0,0,0,0,0,0,0,0,0,0,0,0,0,0,0,0,0,0,0,0,0,0,0,0,0,0,0,0,0,0
2011,5,91,9102,PAPUA BARAT,KAIMANA,0,0,0,0,0,0,0,0,0,0,0,0,0,0,0,0,0,0,0,0,0,0,0,0,0,0,0,0,0,0,0,0
2011,5,94,9403,PAPUA,JAYAPURA,8133,0,4595,1095,0,0,0,0,0,0,0,0,0,0,0,0,0,0,0,0,0,0,0,1645,483,1,220,0,0,0,0,2349
2011,5,94,9471,PAPUA,KOTA JAYAPURA,7631,0,5901,709,0,0,0,0,0,0,0,0,0,0,0,0,0,0,0,0,0,0,18,950,549,3,88,0,0,0,0,1590
2011,5,94,9420,PAPUA,KEEROM,4966,0,3743,584,0,0,0,0,0,0,0,0,0,0,0,0,0,0,0,0,0,0,12,1165,475,0,170,0,0,0,0,1810
2011,5,94,9419,PAPUA,SARMI,0,0,0,0,0,0,0,0,0,0,0,0,0,0,0,0,0,0,0,0,0,0,0,0,0,0,0,0,0,0,0,0
2011,5,94,9409,PAPUA,BIAK NUMFOR,2616,0,1842,395,0,0,0,0,0,0,0,0,0,0,0,0,0,0,0,0,0,0,1,93,311,0,173,0,0,0,0,577
2011,5,94,9427,PAPUA,SUPIORI,53,0,232,59,0,0,0,0,0,0,0,0,0,0,0,0,0,0,0,0,0,0,0,60,42,0,7,0,0,0,0,109
2011,5,94,9401,PAPUA,MERAUKE,1146,0,346,400,0,0,0,0,0,0,0,0,0,0,0,0,0,0,0,0,0,0,0,27,165,0,0,0,0,0,0,192
2011,5,94,9414,PAPUA,MAPPI,1653,0,1305,374,0,0,0,0,0,0,0,0,0,0,0,0,0,0,0,0,0,0,0,90,498,0,17,0,0,0,0,605
2011,5,94,9413,PAPUA,BOVEN DIGOEL,811,0,418,256,0,0,0,0,0,0,0,0,0,0,0,0,0,0,0,0,0,0,1,162,84,0,26,0,0,0,0,272
2011,5,94,9404,PAPUA,NABIRE,4173,0,1686,655,0,0,0,0,0,0,0,0,0,0,0,0,0,0,0,0,0,0,26,1499,381,1,131,0,0,0,0,2012
2011,5,94,9408,PAPUA,KEPULAUAN YAPEN,6373,0,2803,483,0,0,0,0,0,0,0,0,0,0,0,0,0,0,0,0,0,0,63,869,42,0,59,0,0,0,0,970
2011,5,94,9412,PAPUA,MIMIKA,28375,0,12973,1442,0,0,0,0,0,0,0,0,0,0,0,0,0,0,0,0,0,0,35,2588,2319,115,216,0,0,0,0,5238
2011,5,94,9410,PAPUA,PANIAI,539,0,179,230,0,0,0,0,0,0,0,0,0,0,0,0,0,0,0,0,0,0,0,112,191,0,10,0,0,0,0,313
2011,5,94,9415,PAPUA,ASMAT,1844,0,158,278,0,0,0,0,0,0,0,0,0,0,0,0,0,0,0,0,0,0,15,150,89,0,86,0,0,0,0,325
2011,5,94,9426,PAPUA,WAROPEN,523,0,523,0,0,0,0,0,0,0,0,0,0,0,0,0,0,0,0,0,0,0,8,235,55,0,0,0,0,0,0,290
2011,5,94,9402,PAPUA,JAYAWIJAYA,1654,0,1600,54,0,0,0,0,0,0,0,0,0,0,0,0,0,0,0,0,0,0,0,167,241,0,4,0,0,0,0,412
2011,5,94,9411,PAPUA,PUNCAK JAYA,0,0,0,0,0,0,0,0,0,0,0,0,0,0,0,0,0,0,0,0,0,0,0,0,0,0,0,0,0,0,0,0
2011,5,94,9418,PAPUA,TOLIKARA,0,0,0,0,0,0,0,0,0,0,0,0,0,0,0,0,0,0,0,0,0,0,0,0,0,0,0,0,0,0,0,0
2011,5,94,9416,PAPUA,YAHUKIMO,0,0,0,0,0,0,0,0,0,0,0,0,0,0,0,0,0,0,0,0,0,0,0,0,0,0,0,0,0,0,0,0
2011,5,94,9417,PAPUA,PEGUNUNGAN BINTANG,0,0,0,0,0,0,0,0,0,0,0,0,0,0,0,0,0,0,0,0,0,0,0,0,0,0,0,0,0,0,0,0
2011,6,91,9171,PAPUA BARAT,KOTA SORONG,0,0,0,0,0,0,0,0,0,0,0,0,0,0,0,0,0,0,0,0,0,0,0,0,0,0,0,0,0,0,0,0
2011,6,91,9107,PAPUA BARAT,SORONG,0,0,0,0,0,0,0,0,0,0,0,0,0,0,0,0,0,0,0,0,0,0,0,0,0,0,0,0,0,0,0,0
2011,6,91,9106,PAPUA BARAT,SORONG SELATAN,0,0,0,0,0,0,0,0,0,0,0,0,0,0,0,0,0,0,0,0,0,0,0,0,0,0,0,0,0,0,0,0
2011,6,91,9108,PAPUA BARAT,RAJA AMPAT,0,0,0,0,0,0,0,0,0,0,0,0,0,0,0,0,0,0,0,0,0,0,0,0,0,0,0,0,0,0,0,0
2011,6,91,9105,PAPUA BARAT,MANOKWARI,0,0,0,0,0,0,0,0,0,0,0,0,0,0,0,0,0,0,0,0,0,0,0,0,0,0,0,0,0,0,0,0
2011,6,91,9104,PAPUA BARAT,TELUK BINTUNI,0,0,0,0,0,0,0,0,0,0,0,0,0,0,0,0,0,0,0,0,0,0,0,0,0,0,0,0,0,0,0,0
2011,6,91,9103,PAPUA BARAT,TELUK WONDAMA,0,0,0,0,0,0,0,0,0,0,0,0,0,0,0,0,0,0,0,0,0,0,0,0,0,0,0,0,0,0,0,0
2011,6,91,9101,PAPUA BARAT,FAKFAK,0,0,0,0,0,0,0,0,0,0,0,0,0,0,0,0,0,0,0,0,0,0,0,0,0,0,0,0,0,0,0,0
2011,6,91,9102,PAPUA BARAT,KAIMANA,0,0,0,0,0,0,0,0,0,0,0,0,0,0,0,0,0,0,0,0,0,0,0,0,0,0,0,0,0,0,0,0
2011,6,94,9403,PAPUA,JAYAPURA,6437,0,3747,946,0,0,0,0,0,0,0,0,0,0,0,0,0,0,0,0,0,0,0,1235,364,2,87,0,0,0,0,1688
2011,6,94,9471,PAPUA,KOTA JAYAPURA,6916,0,6197,669,0,0,0,0,0,0,0,0,0,0,0,0,0,0,0,0,0,0,19,1133,681,1,46,0,0,0,0,1861
2011,6,94,9420,PAPUA,KEEROM,3610,0,3154,456,0,0,0,0,0,0,0,0,0,0,0,0,0,0,0,0,0,0,5,840,494,0,131,0,0,0,0,1465
2011,6,94,9419,PAPUA,SARMI,0,0,0,0,0,0,0,0,0,0,0,0,0,0,0,0,0,0,0,0,0,0,0,0,0,0,0,0,0,0,0,0
2011,6,94,9409,PAPUA,BIAK NUMFOR,1865,0,1314,284,0,0,0,0,0,0,0,0,0,0,0,0,0,0,0,0,0,0,1,144,257,0,44,0,0,0,0,445
2011,6,94,9427,PAPUA,SUPIORI,3176,0,252,26,0,0,0,0,0,0,0,0,0,0,0,0,0,0,0,0,0,0,0,74,50,0,2,0,0,0,0,126
2011,6,94,9401,PAPUA,MERAUKE,576,0,320,203,0,0,0,0,0,0,0,0,0,0,0,0,0,0,0,0,0,0,0,6,163,0,0,0,0,0,0,169
2011,6,94,9414,PAPUA,MAPPI,1182,0,911,138,0,0,0,0,0,0,0,0,0,0,0,0,0,0,0,0,0,0,0,79,307,0,18,0,0,0,0,404
2011,6,94,9413,PAPUA,BOVEN DIGOEL,825,0,315,369,0,0,0,0,0,0,0,0,0,0,0,0,0,0,0,0,0,0,5,163,87,0,30,0,0,0,0,280
2011,6,94,9404,PAPUA,NABIRE,5867,0,2839,830,0,0,0,0,0,0,0,0,0,0,0,0,0,0,0,0,0,0,59,1662,650,2,145,0,0,0,0,2459
2011,6,94,9408,PAPUA,KEPULAUAN YAPEN,2366,0,1182,588,0,0,0,0,0,0,0,0,0,0,0,0,0,0,0,0,0,0,55,646,55,0,44,0,0,0,0,745
2011,6,94,9412,PAPUA,MIMIKA,13978,0,15719,1470,0,0,0,0,0,0,0,0,0,0,0,0,0,0,0,0,0,0,39,2837,2561,134,197,0,0,0,0,5729
2011,6,94,9410,PAPUA,PANIAI,1191,0,214,847,0,0,0,0,0,0,0,0,0,0,0,0,0,0,0,0,0,0,96,148,192,0,18,0,0,0,0,358
2011,6,94,9415,PAPUA,ASMAT,965,0,450,109,0,0,0,0,0,0,0,0,0,0,0,0,0,0,0,0,0,0,1,234,106,0,40,0,0,0,0,380
2011,6,94,9426,PAPUA,WAROPEN,455,0,455,0,0,0,0,0,0,0,0,0,0,0,0,0,0,0,0,0,0,0,6,225,54,0,0,0,0,0,0,279
2011,6,94,9402,PAPUA,JAYAWIJAYA,1400,0,1235,165,0,0,0,0,0,0,0,0,0,0,0,0,0,0,0,0,0,0,0,107,132,0,5,0,0,0,0,244
2011,6,94,9411,PAPUA,PUNCAK JAYA,0,0,0,0,0,0,0,0,0,0,0,0,0,0,0,0,0,0,0,0,0,0,0,0,0,0,0,0,0,0,0,0
2011,6,94,9418,PAPUA,TOLIKARA,0,0,0,0,0,0,0,0,0,0,0,0,0,0,0,0,0,0,0,0,0,0,0,0,0,0,0,0,0,0,0,0
2011,6,94,9416,PAPUA,YAHUKIMO,0,0,0,0,0,0,0,0,0,0,0,0,0,0,0,0,0,0,0,0,0,0,0,0,0,0,0,0,0,0,0,0
2011,6,94,9417,PAPUA,PEGUNUNGAN BINTANG,0,0,0,0,0,0,0,0,0,0,0,0,0,0,0,0,0,0,0,0,0,0,0,0,0,0,0,0,0,0,0,0
2011,7,91,9171,PAPUA BARAT,KOTA SORONG,2608,0,1561,312,0,24,32,76,71,58,37,57,65,130,91,0,0,203,95,122,221,0,3,73,543,0,12,0,345,296,641,628
2011,7,91,9107,PAPUA BARAT,SORONG,1947,0,1276,337,0,1,3,10,14,11,13,14,12,54,28,0,0,28,24,26,82,0,7,125,26,0,14,0,90,70,160,165
2011,7,91,9106,PAPUA BARAT,SORONG SELATAN,1166,0,1058,92,0,37,55,60,85,29,39,11,19,89,163,0,0,237,68,30,252,0,2,31,553,0,3,0,226,361,587,587
2011,7,91,9108,PAPUA BARAT,RAJA AMPAT,1105,0,116,71,0,1,0,11,10,12,14,11,12,18,21,0,0,22,26,23,39,0,1,19,57,0,9,0,53,57,110,85
2011,7,91,9105,PAPUA BARAT,MANOKWARI,4260,0,3749,675,0,294,288,661,617,648,429,433,390,1207,1310,0,0,1860,1077,823,2517,0,29,1591,4340,0,97,0,3243,3034,6277,6028
2011,7,91,9104,PAPUA BARAT,TELUK BINTUNI,946,0,498,165,0,2,0,7,7,9,6,3,0,33,17,0,0,16,15,3,50,0,1,40,34,0,10,0,54,30,84,84
2011,7,91,9103,PAPUA BARAT,TELUK WONDAMA,964,0,793,95,0,6,3,57,29,18,22,3,12,87,68,0,0,95,40,15,155,0,2,172,109,0,24,0,171,134,305,305
2011,7,91,9101,PAPUA BARAT,FAKFAK,2001,0,1598,321,0,36,33,153,127,80,83,42,34,220,249,0,0,349,163,76,469,0,9,601,243,0,13,0,531,526,1057,857
2011,7,91,9102,PAPUA BARAT,KAIMANA,846,0,500,69,0,3,3,7,9,9,7,4,5,11,27,0,0,22,16,9,38,0,2,54,25,0,6,0,34,51,85,85
2011,7,94,9403,PAPUA,JAYAPURA,6001,0,3699,794,0,18,16,152,111,144,130,102,81,357,383,0,0,297,274,183,740,0,9,1147,272,1,74,0,773,721,1494,1494
2011,7,94,9471,PAPUA,KOTA JAYAPURA,10397,0,4919,613,0,15,13,118,82,99,97,63,79,415,308,0,0,228,196,142,723,0,29,691,494,6,51,0,710,579,1289,1242
2011,7,94,9420,PAPUA,KEEROM,5041,0,4203,838,0,17,10,161,158,158,153,103,102,785,457,0,0,346,311,205,1242,0,22,1323,579,2,200,0,1224,880,2104,2104
2011,7,94,9419,PAPUA,SARMI,292,0,163,39,0,2,2,13,12,16,8,7,7,21,30,0,0,29,24,14,51,0,3,89,29,0,3,0,59,59,118,121
2011,7,94,9409,PAPUA,BIAK NUMFOR,2388,0,1868,338,0,12,9,48,50,47,42,31,27,82,105,0,0,119,89,58,187,0,7,104,311,0,39,0,220,233,453,454
2011,7,94,9427,PAPUA,SUPIORI,540,0,158,382,0,0,1,5,6,4,2,3,2,24,27,0,0,12,6,5,51,0,0,34,40,0,0,0,36,38,74,74
2011,7,94,9401,PAPUA,MERAUKE,934,0,546,249,0,1,6,27,25,14,17,6,9,43,42,0,0,59,31,15,85,0,0,8,183,0,0,0,91,99,190,191
2011,7,94,9414,PAPUA,MAPPI,1281,0,936,100,0,31,24,68,54,39,29,11,15,119,190,0,0,177,68,26,309,0,1,134,428,0,18,0,268,312,580,580
2011,7,94,9413,PAPUA,BOVEN DIGOEL,799,0,454,183,0,14,9,40,44,18,20,11,13,61,107,0,0,107,38,24,168,0,11,237,67,0,33,0,144,193,337,337
2011,7,94,9404,PAPUA,NABIRE,5648,0,3643,608,0,67,57,183,114,121,98,102,67,531,487,0,0,421,219,169,1018,0,33,1292,406,3,126,0,1004,823,1827,1827
2011,7,94,9408,PAPUA,KEPULAUAN YAPEN,2122,0,900,303,0,29,19,60,56,32,34,16,26,121,164,0,0,164,66,42,285,0,20,507,36,0,15,0,258,299,557,558
2011,7,94,9412,PAPUA,MIMIKA,15399,0,12685,1380,0,60,60,365,354,316,283,284,237,1914,1406,0,0,839,599,521,3320,0,30,2654,2322,102,255,0,2939,2340,5279,5333
2011,7,94,9410,PAPUA,PANIAI,717,0,214,373,0,0,0,3,2,16,19,44,39,120,107,0,0,5,35,83,227,0,55,209,156,0,16,0,183,167,350,381
2011,7,94,9415,PAPUA,ASMAT,1993,0,228,365,0,11,12,61,38,34,31,60,32,133,104,0,0,122,65,92,237,0,14,230,161,1,127,0,299,217,516,519
2011,7,94,9426,PAPUA,WAROPEN,0,0,0,0,0,0,0,0,0,0,0,0,0,0,0,0,0,0,0,0,0,0,0,0,0,0,0,0,0,0,0,0
2011,7,94,9402,PAPUA,JAYAWIJAYA,977,0,208,769,0,2,2,13,8,5,8,5,6,67,52,0,0,25,13,11,119,0,0,76,90,0,1,0,92,76,168,167
2011,7,94,9411,PAPUA,PUNCAK JAYA,0,0,0,0,0,0,0,0,0,0,0,0,0,0,0,0,0,0,0,0,0,0,0,0,0,0,0,0,0,0,0,0
2011,7,94,9418,PAPUA,TOLIKARA,0,0,0,0,0,0,0,0,0,0,0,0,0,0,0,0,0,0,0,0,0,0,0,0,0,0,0,0,0,0,0,0
2011,7,94,9416,PAPUA,YAHUKIMO,0,0,0,0,0,0,0,0,0,0,0,0,0,0,0,0,0,0,0,0,0,0,0,0,0,0,0,0,0,0,0,0
2011,7,94,9417,PAPUA,PEGUNUNGAN BINTANG,0,0,0,0,0,0,0,0,0,0,0,0,0,0,0,0,0,0,0,0,0,0,0,0,0,0,0,0,0,0,0,0
2011,8,91,9171,PAPUA BARAT,KOTA SORONG,5331,0,2465,250,0,48,57,145,130,89,79,95,62,164,151,0,0,380,168,157,315,0,0,91,928,1,3,0,541,479,1020,1023
2011,8,91,9107,PAPUA BARAT,SORONG,1367,0,1089,300,0,1,2,14,15,17,19,9,9,39,34,0,0,32,36,18,73,0,0,99,39,0,20,0,80,79,159,158
2011,8,91,9106,PAPUA BARAT,SORONG SELATAN,1181,0,1136,107,0,42,56,42,65,27,42,29,43,106,136,0,0,205,69,72,242,0,0,71,517,1,1,0,246,342,588,590
2011,8,91,9108,PAPUA BARAT,RAJA AMPAT,172,0,0,88,0,0,1,1,1,6,9,26,17,30,40,0,0,3,15,43,70,0,0,9,121,0,0,0,63,68,131,130
2011,8,91,9105,PAPUA BARAT,MANOKWARI,3656,0,3416,357,0,141,156,297,320,208,212,164,129,579,607,0,0,914,420,293,1186,0,12,623,2006,0,77,0,1389,1424,2813,2706
2011,8,91,9104,PAPUA BARAT,TELUK BINTUNI,852,0,753,99,0,1,0,0,1,1,4,1,0,14,6,0,0,2,5,1,20,0,0,16,5,0,10,0,17,11,28,31
2011,8,91,9103,PAPUA BARAT,TELUK WONDAMA,1048,0,868,105,0,10,14,62,53,29,30,15,17,91,86,0,0,139,59,32,177,0,4,219,154,0,34,0,207,200,407,407
2011,8,91,9101,PAPUA BARAT,FAKFAK,3846,0,2096,387,0,34,29,137,128,88,78,42,44,198,194,0,0,328,166,86,392,0,12,715,253,0,13,0,499,473,972,981
2011,8,91,9102,PAPUA BARAT,KAIMANA,659,0,421,78,0,1,1,7,9,4,8,1,3,20,21,0,0,18,12,4,41,0,1,49,18,0,7,0,33,42,75,74
2011,8,94,9403,PAPUA,JAYAPURA,6366,0,3819,855,0,34,37,182,139,154,117,101,70,385,444,0,0,392,271,171,829,0,0,1256,354,2,51,0,856,807,1663,1663
2011,8,94,9471,PAPUA,KOTA JAYAPURA,5319,0,4998,288,0,19,17,82,69,92,86,47,83,329,266,0,0,187,178,130,595,0,12,578,438,17,40,0,569,521,1090,1073
2011,8,94,9420,PAPUA,KEEROM,4453,0,3787,666,0,23,36,132,115,127,104,113,118,580,477,0,0,306,231,231,1057,0,8,1178,467,1,144,0,975,850,1825,1790
2011,8,94,9419,PAPUA,SARMI,329,0,137,72,0,2,2,12,10,9,6,1,3,7,20,0,0,26,15,4,27,0,0,69,6,0,1,0,31,41,72,76
2011,8,94,9409,PAPUA,BIAK NUMFOR,2277,0,1505,299,0,11,16,67,65,53,44,38,39,107,129,0,0,159,97,77,236,0,2,117,423,0,21,0,276,293,569,561
2011,8,94,9427,PAPUA,SUPIORI,442,0,238,179,0,0,0,1,0,5,5,7,4,9,7,0,0,1,10,11,16,0,0,14,22,0,2,0,22,16,38,38
2011,8,94,9401,PAPUA,MERAUKE,928,0,608,283,0,2,5,26,26,11,13,10,10,49,54,0,0,59,24,20,103,0,0,10,196,0,0,0,98,108,206,206
2011,8,94,9414,PAPUA,MAPPI,1114,0,861,219,0,20,8,36,42,23,21,23,6,85,120,0,0,106,44,29,205,0,17,67,326,0,8,0,187,197,384,401
2011,8,94,9413,PAPUA,BOVEN DIGOEL,517,0,316,155,0,10,12,39,22,20,12,12,13,37,83,0,0,83,32,25,120,0,8,127,111,0,22,0,118,142,260,260
2011,8,94,9404,PAPUA,NABIRE,4590,0,2883,421,0,77,75,127,143,118,112,148,133,493,445,0,0,422,230,281,938,0,17,1306,422,2,139,0,963,908,1871,1869
2011,8,94,9408,PAPUA,KEPULAUAN YAPEN,3879,0,2055,476,0,41,25,114,67,72,60,44,41,146,221,0,0,247,132,85,367,0,57,731,75,0,25,0,417,414,831,831
2011,8,94,9412,PAPUA,MIMIKA,13243,0,11813,1418,0,64,52,382,342,293,269,229,183,1814,1455,0,0,840,562,412,3269,0,50,1998,2410,89,287,0,2782,2301,5083,4784
2011,8,94,9410,PAPUA,PANIAI,380,0,106,168,0,0,0,3,2,11,11,19,19,91,88,0,0,5,22,38,179,0,25,153,105,0,11,0,124,120,244,269
2011,8,94,9415,PAPUA,ASMAT,1642,0,128,246,0,83,12,18,12,21,17,14,47,74,83,0,0,125,38,61,157,0,3,117,80,0,62,0,210,171,381,259
2011,8,94,9426,PAPUA,WAROPEN,0,0,0,0,0,0,0,0,0,0,0,0,0,0,0,0,0,0,0,0,0,0,0,0,0,0,0,0,0,0,0,0
2011,8,94,9402,PAPUA,JAYAWIJAYA,553,0,116,437,0,3,1,5,5,3,1,1,3,43,35,0,0,14,4,4,78,0,0,40,58,0,2,0,55,45,100,100
2011,8,94,9411,PAPUA,PUNCAK JAYA,0,0,0,0,0,0,0,0,0,0,0,0,0,0,0,0,0,0,0,0,0,0,0,0,0,0,0,0,0,0,0,0
2011,8,94,9418,PAPUA,TOLIKARA,0,0,0,0,0,0,0,0,0,0,0,0,0,0,0,0,0,0,0,0,0,0,0,0,0,0,0,0,0,0,0,0
2011,8,94,9416,PAPUA,YAHUKIMO,0,0,0,0,0,0,0,0,0,0,0,0,0,0,0,0,0,0,0,0,0,0,0,0,0,0,0,0,0,0,0,0
2011,8,94,9417,PAPUA,PEGUNUNGAN BINTANG,0,0,0,0,0,0,0,0,0,0,0,0,0,0,0,0,0,0,0,0,0,0,0,0,0,0,0,0,0,0,0,0
2011,9,91,9171,PAPUA BARAT,KOTA SORONG,3883,0,2357,107,0,33,29,129,98,92,76,71,72,207,199,0,0,289,168,143,406,0,0,138,861,0,1,0,532,474,1006,1000
2011,9,91,9107,PAPUA BARAT,SORONG,1836,0,1551,263,0,0,6,11,16,20,18,16,13,39,30,0,0,33,38,29,69,0,0,89,38,0,42,0,86,83,169,169
2011,9,91,9106,PAPUA BARAT,SORONG SELATAN,292,0,229,63,0,3,1,10,12,8,12,17,15,26,20,0,0,26,20,32,46,0,1,18,107,0,0,0,64,60,124,125
2011,9,91,9108,PAPUA BARAT,RAJA AMPAT,146,0,52,45,0,0,1,7,5,9,4,3,2,35,14,0,0,13,13,5,49,0,1,14,62,0,5,0,54,26,80,81
2011,9,91,9105,PAPUA BARAT,MANOKWARI,3615,0,3191,424,0,141,159,258,288,185,167,156,131,519,500,0,0,846,352,287,1019,0,1,641,1775,0,91,0,1259,1245,2504,2507
2011,9,91,9104,PAPUA BARAT,TELUK BINTUNI,275,0,250,25,0,0,0,0,0,3,0,1,0,4,0,0,0,0,3,1,4,0,0,4,4,0,0,0,8,0,8,8
2011,9,91,9103,PAPUA BARAT,TELUK WONDAMA,896,0,591,174,0,19,9,46,40,12,19,9,12,79,88,0,0,114,31,21,167,0,9,209,87,0,37,0,165,168,333,333
2011,9,91,9101,PAPUA BARAT,FAKFAK,1784,0,1455,329,0,42,34,92,79,62,67,25,23,154,142,0,0,247,129,48,296,0,19,503,216,1,0,0,375,345,720,720
2011,9,91,9102,PAPUA BARAT,KAIMANA,877,0,388,109,0,3,3,6,3,7,7,5,3,13,16,0,0,15,14,8,29,0,4,45,19,0,4,0,34,32,66,68
2011,9,94,9403,PAPUA,JAYAPURA,6431,0,3672,906,0,34,30,232,201,187,162,114,92,332,447,0,0,497,349,206,779,0,8,1189,463,0,179,0,899,932,1831,1831
2011,9,94,9471,PAPUA,KOTA JAYAPURA,5877,0,5201,608,0,24,21,90,88,101,100,71,86,347,296,0,0,223,201,157,643,0,11,690,485,8,74,0,633,591,1224,1257
2011,9,94,9420,PAPUA,KEEROM,5449,0,4774,675,0,31,30,172,161,159,167,118,135,701,540,0,0,394,326,253,1241,0,11,1335,671,1,207,0,1181,1033,2214,2214
2011,9,94,9419,PAPUA,SARMI,268,0,165,6,0,8,2,14,11,8,8,6,0,8,13,0,0,35,16,6,21,0,0,73,5,0,0,0,44,34,78,78
2011,9,94,9409,PAPUA,BIAK NUMFOR,2104,0,1711,264,0,8,8,67,44,53,30,34,29,83,138,0,0,127,83,63,221,0,0,104,354,0,36,0,245,249,494,494
2011,9,94,9427,PAPUA,SUPIORI,316,0,171,70,0,2,1,6,7,14,13,5,13,14,25,0,0,16,27,18,39,0,0,22,64,0,15,0,41,59,100,101
2011,9,94,9401,PAPUA,MERAUKE,895,0,560,207,0,3,3,21,16,15,13,17,14,30,41,0,0,43,28,31,71,0,2,16,152,0,1,0,86,87,173,169
2011,9,94,9414,PAPUA,MAPPI,1010,0,566,200,0,13,5,43,31,23,24,10,10,35,59,0,0,92,47,20,94,0,1,91,146,0,9,0,124,129,253,246
2011,9,94,9413,PAPUA,BOVEN DIGOEL,598,0,272,218,0,1,3,29,19,11,6,7,8,28,39,0,0,52,17,15,67,0,2,61,64,0,28,0,76,75,151,153
2011,9,94,9404,PAPUA,NABIRE,4405,0,2570,93,0,43,37,88,79,50,56,53,51,386,400,0,0,247,106,104,786,0,10,837,298,2,113,0,620,623,1243,1250
2011,9,94,9408,PAPUA,KEPULAUAN YAPEN,1832,0,1131,249,0,25,30,54,78,42,37,48,43,111,175,0,0,187,79,91,286,0,45,616,21,0,6,0,280,363,643,643
2011,9,94,9412,PAPUA,MIMIKA,8968,0,8573,395,0,36,38,216,202,170,150,118,104,909,683,0,0,492,320,222,1592,0,10,1286,1128,71,144,0,1449,1177,2626,2629
2011,9,94,9410,PAPUA,PANIAI,812,0,204,325,0,0,0,3,3,13,15,36,37,125,118,0,0,6,28,73,243,0,0,206,123,0,24,0,177,173,350,353
2011,9,94,9415,PAPUA,ASMAT,430,0,57,265,0,1,6,7,6,3,6,6,47,52,67,0,0,20,9,53,119,0,0,86,38,0,31,0,69,132,201,155
2011,9,94,9426,PAPUA,WAROPEN,0,0,0,0,0,0,0,0,0,0,0,0,0,0,0,0,0,0,0,0,0,0,0,0,0,0,0,0,0,0,0,0
2011,9,94,9402,PAPUA,JAYAWIJAYA,773,0,92,681,0,3,2,8,6,1,1,3,0,33,30,0,0,19,2,3,63,0,0,26,61,0,0,0,48,39,87,87
2011,9,94,9411,PAPUA,PUNCAK JAYA,0,0,0,0,0,0,0,0,0,0,0,0,0,0,0,0,0,0,0,0,0,0,0,0,0,0,0,0,0,0,0,0
2011,9,94,9418,PAPUA,TOLIKARA,0,0,0,0,0,0,0,0,0,0,0,0,0,0,0,0,0,0,0,0,0,0,0,0,0,0,0,0,0,0,0,0
2011,9,94,9416,PAPUA,YAHUKIMO,0,0,0,0,0,0,0,0,0,0,0,0,0,0,0,0,0,0,0,0,0,0,0,0,0,0,0,0,0,0,0,0
2011,9,94,9417,PAPUA,PEGUNUNGAN BINTANG,0,0,0,0,0,0,0,0,0,0,0,0,0,0,0,0,0,0,0,0,0,0,0,0,0,0,0,0,0,0,0,0
2011,10,91,9171,PAPUA BARAT,KOTA SORONG,2987,0,2527,207,0,31,20,85,94,64,48,49,56,151,134,0,0,230,112,105,285,0,0,95,226,413,6,0,380,352,732,740
2011,10,91,9107,PAPUA BARAT,SORONG,1728,0,1355,174,0,10,10,14,12,11,11,8,7,49,35,0,0,46,22,15,84,0,0,103,49,0,17,0,92,75,167,169
2011,10,91,9106,PAPUA BARAT,SORONG SELATAN,2346,0,1091,114,0,13,9,41,47,33,36,32,49,143,178,0,0,110,69,81,321,0,0,54,526,0,1,0,262,319,581,581
2011,10,91,9108,PAPUA BARAT,RAJA AMPAT,119,0,59,17,0,0,0,2,0,3,9,3,4,32,15,0,0,2,12,7,47,0,0,7,61,0,0,0,40,28,68,68
2011,10,91,9105,PAPUA BARAT,MANOKWARI,2516,0,2161,133,0,97,95,276,279,106,84,55,54,302,353,0,0,747,190,109,655,0,6,644,1038,0,13,0,836,865,1701,1695
2011,10,91,9104,PAPUA BARAT,TELUK BINTUNI,343,0,277,66,0,0,0,4,3,2,2,1,1,5,2,0,0,7,4,2,7,0,0,17,2,0,1,0,12,8,20,20
2011,10,91,9103,PAPUA BARAT,TELUK WONDAMA,966,0,835,29,0,9,12,44,33,7,20,8,7,112,92,0,0,98,27,15,204,0,0,259,68,2,4,0,180,164,344,333
2011,10,91,9101,PAPUA BARAT,FAKFAK,3108,0,1942,324,0,34,27,128,108,81,58,23,21,121,129,0,0,297,139,44,250,0,24,557,174,1,2,0,387,343,730,734
2011,10,91,9102,PAPUA BARAT,KAIMANA,858,0,509,1,0,5,4,12,9,6,4,5,4,9,14,0,0,30,10,9,23,0,0,32,35,0,4,0,37,35,72,71
2011,10,94,9403,PAPUA,JAYAPURA,6502,0,3785,777,0,37,36,212,203,179,145,102,85,426,433,0,0,488,324,187,859,0,0,1200,522,0,136,0,956,902,1858,1858
2011,10,94,9471,PAPUA,KOTA JAYAPURA,5268,0,4967,301,0,22,29,105,106,81,103,49,82,337,312,0,0,262,184,131,649,0,7,717,537,5,97,0,594,632,1226,1356
2011,10,94,9420,PAPUA,KEEROM,4321,0,4887,491,0,27,20,186,186,210,191,182,137,778,677,0,0,419,401,319,1455,0,1,1621,781,0,198,0,1383,1211,2594,2600
2011,10,94,9419,PAPUA,SARMI,36,0,0,4,0,1,0,0,0,1,1,0,0,1,0,0,0,1,2,0,1,0,0,4,0,0,0,0,3,1,4,4
2011,10,94,9409,PAPUA,BIAK NUMFOR,2041,0,1527,192,0,9,4,43,42,38,29,16,14,52,72,0,0,98,67,30,124,0,0,61,250,0,7,0,158,161,319,318
2011,10,94,9427,PAPUA,SUPIORI,322,0,135,81,0,1,0,0,4,6,7,6,12,28,13,0,0,5,13,18,41,0,0,31,24,0,22,0,41,36,77,77
2011,10,94,9401,PAPUA,MERAUKE,827,0,596,233,0,4,5,21,2,28,25,22,17,25,26,0,0,32,53,39,51,0,8,6,185,0,0,0,100,75,175,191
2011,10,94,9414,PAPUA,MAPPI,1083,0,701,198,0,15,8,33,37,26,16,9,2,60,73,0,0,93,42,11,133,0,0,92,167,0,20,0,143,136,279,279
2011,10,94,9413,PAPUA,BOVEN DIGOEL,803,0,402,268,0,10,12,48,29,25,27,8,11,46,87,0,0,99,52,19,133,0,11,137,135,0,34,0,137,166,303,306
2011,10,94,9404,PAPUA,NABIRE,2760,0,1393,185,0,36,43,93,93,56,40,25,32,318,337,0,0,265,96,57,655,0,8,856,154,2,57,0,528,545,1073,1069
2011,10,94,9408,PAPUA,KEPULAUAN YAPEN,1703,0,949,193,0,31,15,77,60,37,25,16,36,57,135,0,0,183,62,52,192,0,0,450,18,0,23,0,218,271,489,491
2011,10,94,9412,PAPUA,MIMIKA,9858,0,9460,380,0,27,29,293,248,248,201,148,144,1408,1129,0,0,597,449,292,2537,0,21,1901,1742,64,173,0,2124,1751,3875,3880
2011,10,94,9410,PAPUA,PANIAI,539,0,179,230,0,0,0,2,3,9,10,19,19,108,95,0,0,5,19,38,203,0,32,168,112,0,9,0,138,127,265,289
2011,10,94,9415,PAPUA,ASMAT,312,0,102,149,0,0,0,2,4,7,9,11,12,50,23,0,0,6,16,23,73,0,0,48,32,0,38,0,70,48,118,118
2011,10,94,9426,PAPUA,WAROPEN,0,0,0,0,0,0,0,0,0,0,0,0,0,0,0,0,0,0,0,0,0,0,0,0,0,0,0,0,0,0,0,0
2011,10,94,9402,PAPUA,JAYAWIJAYA,836,0,91,765,0,1,0,1,4,1,2,3,7,30,32,0,0,6,3,10,62,0,0,37,45,0,0,0,36,45,81,82
2011,10,94,9411,PAPUA,PUNCAK JAYA,0,0,0,0,0,0,0,0,0,0,0,0,0,0,0,0,0,0,0,0,0,0,0,0,0,0,0,0,0,0,0,0
2011,10,94,9418,PAPUA,TOLIKARA,0,0,0,0,0,0,0,0,0,0,0,0,0,0,0,0,0,0,0,0,0,0,0,0,0,0,0,0,0,0,0,0
2011,10,94,9416,PAPUA,YAHUKIMO,0,0,0,0,0,0,0,0,0,0,0,0,0,0,0,0,0,0,0,0,0,0,0,0,0,0,0,0,0,0,0,0
2011,10,94,9417,PAPUA,PEGUNUNGAN BINTANG,0,0,0,0,0,0,0,0,0,0,0,0,0,0,0,0,0,0,0,0,0,0,0,0,0,0,0,0,0,0,0,0
2011,11,91,9171,PAPUA BARAT,KOTA SORONG,3356,0,2968,178,0,47,44,95,82,82,75,66,58,166,159,0,0,268,157,124,325,0,0,123,709,0,1,0,456,418,874,833
2011,11,91,9107,PAPUA BARAT,SORONG,1834,0,1527,196,0,2,2,6,14,18,12,18,13,60,46,0,0,24,30,31,106,0,1,91,72,0,26,0,104,87,191,189
2011,11,91,9106,PAPUA BARAT,SORONG SELATAN,819,0,751,68,0,8,6,14,14,23,18,20,13,25,16,0,0,42,41,33,41,0,0,5,150,0,0,0,90,67,157,155
2011,11,91,9108,PAPUA BARAT,RAJA AMPAT,74,0,20,18,0,0,0,0,1,6,5,6,6,23,4,0,0,1,11,12,27,0,0,40,2,0,9,0,35,16,51,51
2011,11,91,9105,PAPUA BARAT,MANOKWARI,3202,0,3185,17,0,108,103,216,216,103,99,71,62,295,345,0,0,643,202,133,640,0,7,639,976,0,3,0,793,825,1618,1618
2011,11,91,9104,PAPUA BARAT,TELUK BINTUNI,278,0,271,7,0,0,0,1,3,0,1,2,0,7,5,0,0,4,1,2,12,0,0,9,8,0,2,0,10,9,19,19
2011,11,91,9103,PAPUA BARAT,TELUK WONDAMA,950,0,893,5,0,13,18,49,32,26,31,13,10,81,60,0,0,112,57,23,141,0,1,209,118,6,0,0,182,151,333,333
2011,11,91,9101,PAPUA BARAT,FAKFAK,2393,0,2137,244,0,32,32,112,110,55,56,26,26,114,124,0,0,286,111,52,238,0,30,511,177,0,10,0,339,348,687,698
2011,11,91,9102,PAPUA BARAT,KAIMANA,1049,0,604,100,0,5,2,16,13,14,13,6,6,18,20,0,0,36,27,12,38,0,0,86,26,0,1,0,59,54,113,113
2011,11,94,9403,PAPUA,JAYAPURA,6292,0,3937,555,0,32,36,199,173,148,145,95,85,357,386,0,0,440,293,180,743,0,1,1109,409,0,138,0,831,825,1656,1656
2011,11,94,9471,PAPUA,KOTA JAYAPURA,4328,0,4162,166,0,14,14,100,86,86,76,45,67,315,209,0,0,214,162,112,524,0,4,551,508,5,78,0,560,452,1012,1142
2011,11,94,9420,PAPUA,KEEROM,6597,0,5979,574,0,35,30,222,233,253,232,158,142,983,748,0,0,520,485,300,1731,0,12,1820,960,0,206,0,1651,1385,3036,2986
2011,11,94,9419,PAPUA,SARMI,0,0,0,0,0,0,0,0,0,0,0,0,0,0,0,0,0,0,0,0,0,0,0,0,0,0,0,0,0,0,0,0
2011,11,94,9409,PAPUA,BIAK NUMFOR,1517,0,1180,109,0,4,14,35,31,29,18,18,16,42,85,0,0,84,47,34,127,0,1,63,216,0,9,0,128,164,292,288
2011,11,94,9427,PAPUA,SUPIORI,267,0,105,43,0,2,0,0,1,0,0,0,2,3,10,0,0,3,0,2,13,0,0,4,19,0,0,0,5,13,18,23
2011,11,94,9401,PAPUA,MERAUKE,796,0,487,166,0,8,6,28,28,19,19,19,14,36,26,0,0,70,38,33,62,0,3,10,194,0,0,0,110,93,203,204
2011,11,94,9414,PAPUA,MAPPI,1272,0,996,276,0,16,20,38,25,38,37,14,23,26,64,0,0,99,75,37,90,0,0,143,158,0,18,0,132,169,301,319
2011,11,94,9413,PAPUA,BOVEN DIGOEL,690,0,359,163,0,18,12,43,22,15,14,11,9,42,67,0,0,95,29,20,109,0,0,128,99,0,26,0,129,124,253,253
2011,11,94,9404,PAPUA,NABIRE,1323,0,502,237,0,5,8,23,13,19,10,9,10,87,74,0,0,49,29,19,161,0,8,193,47,0,12,0,143,115,258,252
2011,11,94,9408,PAPUA,KEPULAUAN YAPEN,1913,0,925,141,0,24,16,66,47,49,46,16,16,78,134,0,0,153,95,32,212,0,29,397,21,0,3,0,233,259,492,421
2011,11,94,9412,PAPUA,MIMIKA,9843,0,8500,1343,0,42,45,274,278,251,212,174,151,1585,1373,0,0,639,463,325,2958,0,45,2121,1934,52,321,0,2326,2059,4385,4428
2011,11,94,9410,PAPUA,PANIAI,691,0,196,349,0,0,0,2,2,7,7,20,17,109,123,0,0,4,14,37,232,0,16,169,122,0,8,0,138,149,287,299
2011,11,94,9415,PAPUA,ASMAT,81,0,44,37,0,0,0,1,3,1,3,6,2,11,16,0,0,4,4,8,27,0,0,27,11,0,5,0,19,24,43,43
2011,11,94,9426,PAPUA,WAROPEN,0,0,0,0,0,0,0,0,0,0,0,0,0,0,0,0,0,0,0,0,0,0,0,0,0,0,0,0,0,0,0,0
2011,11,94,9402,PAPUA,JAYAWIJAYA,825,0,77,748,0,2,0,4,3,2,0,0,1,47,19,0,0,9,2,1,66,0,0,28,53,0,0,0,55,23,78,81
2011,11,94,9411,PAPUA,PUNCAK JAYA,0,0,0,0,0,0,0,0,0,0,0,0,0,0,0,0,0,0,0,0,0,0,0,0,0,0,0,0,0,0,0,0
2011,11,94,9418,PAPUA,TOLIKARA,0,0,0,0,0,0,0,0,0,0,0,0,0,0,0,0,0,0,0,0,0,0,0,0,0,0,0,0,0,0,0,0
2011,11,94,9416,PAPUA,YAHUKIMO,0,0,0,0,0,0,0,0,0,0,0,0,0,0,0,0,0,0,0,0,0,0,0,0,0,0,0,0,0,0,0,0
2011,11,94,9417,PAPUA,PEGUNUNGAN BINTANG,0,0,0,0,0,0,0,0,0,0,0,0,0,0,0,0,0,0,0,0,0,0,0,0,0,0,0,0,0,0,0,0
2011,12,91,9171,PAPUA BARAT,KOTA SORONG,2024,0,1693,94,0,23,15,82,53,29,33,32,14,92,82,0,0,173,62,46,174,0,1,156,294,0,3,0,258,197,455,453
2011,12,91,9107,PAPUA BARAT,SORONG,1473,0,1069,134,0,3,1,15,11,21,15,14,10,57,37,0,0,30,36,24,94,0,4,93,46,0,45,0,110,74,184,184
2011,12,91,9106,PAPUA BARAT,SORONG SELATAN,216,0,129,87,0,2,2,4,2,8,6,4,4,6,3,0,0,10,14,8,9,0,0,4,38,0,1,0,24,17,41,43
2011,12,91,9108,PAPUA BARAT,RAJA AMPAT,75,0,36,20,0,0,0,0,2,4,2,4,0,34,8,0,0,2,6,4,42,0,0,5,43,0,0,0,42,12,54,48
2011,12,91,9105,PAPUA BARAT,MANOKWARI,1588,0,1484,104,0,74,65,116,140,40,36,30,20,127,203,0,0,395,76,50,330,0,2,31,307,0,0,0,387,464,851,338
2011,12,91,9104,PAPUA BARAT,TELUK BINTUNI,0,0,0,0,0,0,0,0,0,0,0,0,0,0,0,0,0,0,0,0,0,0,0,0,0,0,0,0,0,0,0,0
2011,12,91,9103,PAPUA BARAT,TELUK WONDAMA,465,0,380,0,0,2,2,38,8,4,24,21,18,21,26,0,0,50,28,39,47,0,0,81,82,0,1,0,86,78,164,164
2011,12,91,9101,PAPUA BARAT,FAKFAK,1500,0,1002,153,0,19,29,95,61,32,34,19,23,77,116,0,0,204,66,42,193,0,0,384,90,0,0,0,242,263,505,474
2011,12,91,9102,PAPUA BARAT,KAIMANA,801,0,648,56,0,2,3,16,17,6,4,3,4,18,15,0,0,38,10,7,33,0,0,54,34,0,0,0,45,43,88,88
2011,12,94,9403,PAPUA,JAYAPURA,4876,0,2864,430,0,32,36,174,155,158,114,84,89,390,351,0,0,397,272,173,741,0,0,1106,391,2,74,0,838,745,1583,1573
2011,12,94,9471,PAPUA,KOTA JAYAPURA,4548,0,4380,162,0,11,12,108,105,75,86,49,46,421,241,0,0,236,161,95,662,0,4,628,538,1,43,0,664,490,1154,1210
2011,12,94,9420,PAPUA,KEEROM,6355,0,5624,731,0,26,20,238,190,234,208,134,128,889,664,0,0,474,442,262,1553,0,8,1601,1022,0,108,0,1521,1210,2731,2731
2011,12,94,9419,PAPUA,SARMI,0,0,0,0,0,0,0,0,0,0,0,0,0,0,0,0,0,0,0,0,0,0,0,0,0,0,0,0,0,0,0,0
2011,12,94,9409,PAPUA,BIAK NUMFOR,1115,0,772,230,0,2,13,29,29,28,20,18,15,44,53,0,0,73,48,33,97,0,0,68,173,0,10,0,121,130,251,251
2011,12,94,9427,PAPUA,SUPIORI,322,0,169,48,0,1,0,14,5,7,6,9,8,24,16,0,0,20,13,17,40,0,0,15,31,0,44,0,55,35,90,90
2011,12,94,9401,PAPUA,MERAUKE,978,0,703,238,0,10,7,37,39,15,11,19,20,41,31,0,0,93,26,39,72,0,0,32,198,0,0,0,122,108,230,230
2011,12,94,9414,PAPUA,MAPPI,826,0,586,238,0,6,12,35,25,32,28,39,33,74,73,0,0,78,60,72,147,0,0,155,182,0,20,0,186,171,357,357
2011,12,94,9413,PAPUA,BOVEN DIGOEL,371,0,268,80,0,4,3,6,6,6,4,13,4,19,12,0,0,19,10,17,31,0,15,45,21,0,11,0,48,29,77,77
2011,12,94,9404,PAPUA,NABIRE,323,0,180,0,0,10,19,20,24,10,10,10,10,17,20,0,0,73,20,20,37,0,0,100,40,2,8,0,67,83,150,150
2011,12,94,9408,PAPUA,KEPULAUAN YAPEN,1229,0,715,58,0,12,8,28,27,20,17,7,10,25,43,0,0,75,37,17,68,0,0,176,11,0,7,0,92,105,197,194
2011,12,94,9412,PAPUA,MIMIKA,10559,0,9131,1428,0,43,46,321,320,308,257,209,196,1758,1491,0,0,730,565,405,3249,0,450,2598,2068,60,385,0,2639,2310,4949,5111
2011,12,94,9410,PAPUA,PANIAI,0,0,0,0,0,0,0,0,0,0,0,0,0,0,0,0,0,0,0,0,0,0,0,0,0,0,0,0,0,0,0,0
2011,12,94,9415,PAPUA,ASMAT,97,0,69,15,0,0,0,2,1,2,5,3,3,16,17,0,0,3,7,6,33,0,0,25,15,0,9,0,23,26,49,49
2011,12,94,9426,PAPUA,WAROPEN,0,0,0,0,0,0,0,0,0,0,0,0,0,0,0,0,0,0,0,0,0,0,0,0,0,0,0,0,0,0,0,0
2011,12,94,9402,PAPUA,JAYAWIJAYA,0,0,0,0,0,0,0,0,0,0,0,0,0,0,0,0,0,0,0,0,0,0,0,0,0,0,0,0,0,0,0,0
2011,12,94,9411,PAPUA,PUNCAK JAYA,0,0,0,0,0,0,0,0,0,0,0,0,0,0,0,0,0,0,0,0,0,0,0,0,0,0,0,0,0,0,0,0
2011,12,94,9418,PAPUA,TOLIKARA,0,0,0,0,0,0,0,0,0,0,0,0,0,0,0,0,0,0,0,0,0,0,0,0,0,0,0,0,0,0,0,0
2011,12,94,9416,PAPUA,YAHUKIMO,0,0,0,0,0,0,0,0,0,0,0,0,0,0,0,0,0,0,0,0,0,0,0,0,0,0,0,0,0,0,0,0
2011,12,94,9417,PAPUA,PEGUNUNGAN BINTANG,0,0,0,0,0,0,0,0,0,0,0,0,0,0,0,0,0,0,0,0,0,0,0,0,0,0,0,0,0,0,0,0
2012,1,91,9171,PAPUA BARAT,KOTA SORONG,3267,0,2705,310,0,70,54,167,162,128,76,98,90,224,196,0,0,453,204,188,420,0,0,189,1083,0,3,0,687,578,1265,1275
2012,1,91,9107,PAPUA BARAT,SORONG,2195,0,1811,96,0,1,2,13,15,12,13,10,9,58,39,0,0,31,25,19,97,0,0,106,47,0,19,0,94,78,172,172
2012,1,91,9106,PAPUA BARAT,SORONG SELATAN,737,0,737,12,0,4,11,16,29,13,16,17,18,25,34,0,0,60,29,35,59,0,0,20,163,0,0,0,75,108,183,183
2012,1,91,9108,PAPUA BARAT,RAJA AMPAT,1114,0,101,747,0,6,11,15,17,30,31,67,60,165,206,0,0,49,61,127,371,0,2,77,498,0,41,0,283,325,608,616
2012,1,91,9105,PAPUA BARAT,MANOKWARI,4442,0,4050,92,0,160,114,346,291,138,103,78,81,345,404,0,0,911,241,159,749,0,11,698,1354,0,32,0,1067,993,2060,2084
2012,1,91,9104,PAPUA BARAT,TELUK BINTUNI,352,0,298,54,0,0,0,1,2,0,0,2,0,19,8,0,0,3,0,2,27,0,0,25,6,0,1,0,22,10,32,32
2012,1,91,9103,PAPUA BARAT,TELUK WONDAMA,971,0,845,34,0,13,5,61,38,21,20,7,5,54,53,0,0,117,41,12,107,0,6,156,118,0,3,0,156,121,277,277
2012,1,91,9101,PAPUA BARAT,FAKFAK,1626,0,2432,81,0,51,47,159,156,83,77,51,28,174,162,0,0,413,160,79,336,0,23,774,214,0,0,0,518,470,988,988
2012,1,91,9102,PAPUA BARAT,KAIMANA,898,0,897,91,0,2,3,6,10,3,2,3,2,37,16,0,0,21,5,5,53,0,0,50,34,0,0,0,51,33,84,84
2012,1,94,9403,PAPUA,JAYAPURA,6385,0,3377,1053,0,27,21,210,332,391,343,262,228,1173,1143,0,0,590,734,490,2316,0,20,2929,1047,2,365,0,2063,2067,4130,4343
2012,1,94,9471,PAPUA,KOTA JAYAPURA,5975,0,5797,153,0,27,13,114,113,122,96,81,95,555,359,0,0,267,218,176,914,0,3,831,688,1,41,0,899,676,1575,1561
2012,1,94,9420,PAPUA,KEEROM,8002,0,7387,591,0,26,34,301,310,351,288,230,188,1205,996,0,0,671,639,418,2201,0,19,2343,1399,1,186,0,2113,1816,3929,3929
2012,1,94,9419,PAPUA,SARMI,194,0,114,29,0,2,0,18,14,18,9,10,10,24,30,0,0,34,27,20,54,0,9,101,26,0,8,0,72,63,135,135
2012,1,94,9409,PAPUA,BIAK NUMFOR,2491,0,2132,109,0,11,24,48,37,52,37,37,40,80,122,0,0,120,89,77,202,0,5,106,368,0,14,0,228,260,488,488
2012,1,94,9427,PAPUA,SUPIORI,460,0,240,211,0,0,0,0,2,2,3,5,1,20,11,0,0,2,5,6,31,0,2,10,32,0,1,0,27,17,44,43
2012,1,94,9401,PAPUA,MERAUKE,2567,0,579,452,0,7,6,68,57,46,52,47,39,126,80,0,0,138,98,86,206,0,0,58,468,0,1,0,294,234,528,527
2012,1,94,9414,PAPUA,MAPPI,1141,0,687,398,0,7,10,68,55,29,42,19,29,106,78,0,0,140,71,48,184,0,0,251,121,0,71,0,229,214,443,443
2012,1,94,9413,PAPUA,BOVEN DIGOEL,964,0,534,281,0,26,29,73,46,29,22,25,23,96,146,0,0,174,51,48,242,0,17,302,157,0,57,0,249,266,515,516
2012,1,94,9404,PAPUA,NABIRE,8924,0,4265,487,0,81,70,206,173,164,153,149,183,660,540,0,0,530,317,332,1200,0,30,1591,580,2,206,0,1260,1119,2379,2379
2012,1,94,9408,PAPUA,KEPULAUAN YAPEN,1681,0,1107,167,0,20,23,49,51,26,38,10,17,103,99,0,0,143,64,27,202,0,37,400,24,0,9,0,208,228,436,433
2012,1,94,9412,PAPUA,MIMIKA,17922,0,16264,1650,0,64,71,524,489,404,393,346,284,2898,2298,0,0,1148,797,630,5196,0,36,4067,3025,86,560,0,4236,3535,7771,7738
2012,1,94,9410,PAPUA,PANIAI,548,0,180,238,0,0,0,1,2,94,8,15,17,69,76,0,0,3,102,32,145,0,46,115,115,0,9,0,179,103,282,239
2012,1,94,9415,PAPUA,ASMAT,1018,0,204,466,0,28,32,75,69,51,41,27,24,172,154,0,0,204,92,51,326,0,10,351,154,0,166,0,353,320,673,671
2012,1,94,9426,PAPUA,WAROPEN,857,0,379,131,0,8,9,35,9,35,28,20,16,73,83,0,0,61,63,36,156,0,0,199,12,0,0,0,171,145,316,211
2012,1,94,9402,PAPUA,JAYAWIJAYA,982,0,192,790,0,2,1,9,7,6,3,7,3,71,51,0,0,19,9,10,122,0,0,86,73,0,1,0,95,65,160,160
2012,1,94,9411,PAPUA,PUNCAK JAYA,0,0,0,0,0,0,0,0,0,0,0,0,0,0,0,0,0,0,0,0,0,0,0,0,0,0,0,0,0,0,0,0
2012,1,94,9418,PAPUA,TOLIKARA,0,0,0,0,0,0,0,0,0,0,0,0,0,0,0,0,0,0,0,0,0,0,0,0,0,0,0,0,0,0,0,0
2012,1,94,9416,PAPUA,YAHUKIMO,0,0,0,0,0,0,0,0,0,0,0,0,0,0,0,0,0,0,0,0,0,0,0,0,0,0,0,0,0,0,0,0
2012,1,94,9417,PAPUA,PEGUNUNGAN BINTANG,0,0,0,0,0,0,0,0,0,0,0,0,0,0,0,0,0,0,0,0,0,0,0,0,0,0,0,0,0,0,0,0
2012,2,91,9171,PAPUA BARAT,KOTA SORONG,1904,0,1467,130,0,10,10,29,31,44,27,30,22,72,70,0,0,80,71,52,142,0,0,91,259,0,5,0,185,160,345,355
2012,2,91,9107,PAPUA BARAT,SORONG,2222,0,1761,122,0,1,4,12,9,16,10,7,7,47,47,0,0,26,26,14,94,0,1,100,45,0,15,0,83,77,160,160
2012,2,91,9106,PAPUA BARAT,SORONG SELATAN,906,0,906,11,0,13,18,49,61,25,28,32,34,104,129,0,0,141,53,66,233,0,0,29,464,0,0,0,223,270,493,493
2012,2,91,9108,PAPUA BARAT,RAJA AMPAT,120,0,45,28,0,0,0,1,2,3,3,8,6,31,19,0,0,3,6,14,50,0,0,5,68,0,0,0,43,30,73,73
2012,2,91,9105,PAPUA BARAT,MANOKWARI,3144,0,2654,2,0,70,81,138,116,65,52,56,49,196,285,0,0,405,117,105,481,0,0,412,683,0,13,0,525,583,1108,1108
2012,2,91,9104,PAPUA BARAT,TELUK BINTUNI,241,0,232,9,0,1,0,4,6,3,3,1,0,8,7,0,0,11,6,1,15,0,0,21,7,0,5,0,17,16,33,33
2012,2,91,9103,PAPUA BARAT,TELUK WONDAMA,1066,0,865,103,0,16,10,59,50,26,27,20,9,106,63,0,0,135,53,29,169,0,17,184,155,0,47,0,227,159,386,386
2012,2,91,9101,PAPUA BARAT,FAKFAK,1428,0,2110,209,0,38,32,134,137,74,53,43,26,145,143,0,0,341,127,69,288,0,30,646,176,1,6,0,434,391,825,829
2012,2,91,9102,PAPUA BARAT,KAIMANA,426,0,366,32,0,6,1,10,12,12,3,3,8,22,20,0,0,29,15,11,42,0,0,55,16,0,0,0,53,44,97,71
2012,2,94,9403,PAPUA,JAYAPURA,7756,0,4299,1000,0,52,31,253,227,242,233,188,182,683,580,0,0,563,475,370,1263,0,18,1824,719,1,127,0,1418,1253,2671,2671
2012,2,94,9471,PAPUA,KOTA JAYAPURA,7226,0,6809,417,0,23,15,131,113,145,124,113,70,638,501,0,0,282,269,183,1139,0,10,956,815,4,64,0,1050,823,1873,1839
2012,2,94,9420,PAPUA,KEEROM,8792,0,7980,812,0,41,42,266,280,324,299,230,214,1237,949,0,0,629,623,444,2186,0,10,2359,1311,4,208,0,2098,1784,3882,3882
2012,2,94,9419,PAPUA,SARMI,238,0,131,39,0,2,2,28,15,19,16,5,6,27,41,0,0,47,35,11,68,0,6,123,34,0,4,0,81,80,161,161
2012,2,94,9409,PAPUA,BIAK NUMFOR,2443,0,2274,60,0,5,20,50,45,56,45,38,30,71,117,0,0,120,101,68,188,0,1,124,329,0,24,0,220,257,477,477
2012,2,94,9427,PAPUA,SUPIORI,1066,0,146,183,0,1,2,12,15,12,14,16,12,57,48,0,0,30,26,28,105,0,1,83,79,0,24,0,98,91,189,186
2012,2,94,9401,PAPUA,MERAUKE,882,0,544,245,0,12,12,57,55,23,17,10,5,50,54,0,0,136,40,15,104,0,0,17,276,0,2,0,152,143,295,295
2012,2,94,9414,PAPUA,MAPPI,1485,0,582,764,0,15,16,54,61,46,48,27,26,60,59,0,0,146,94,53,119,0,8,209,166,0,39,0,202,210,412,414
2012,2,94,9413,PAPUA,BOVEN DIGOEL,779,0,531,233,0,12,17,40,45,21,30,14,13,100,133,0,0,114,51,27,233,0,17,192,173,0,30,0,187,238,425,395
2012,2,94,9404,PAPUA,NABIRE,7922,0,3880,374,0,36,26,137,96,94,84,57,51,568,431,0,0,295,178,108,999,0,33,1159,324,4,114,0,892,688,1580,1601
2012,2,94,9408,PAPUA,KEPULAUAN YAPEN,1242,0,625,311,0,14,9,54,37,29,39,20,16,58,101,0,0,114,68,36,159,0,37,235,93,0,49,0,175,202,377,377
2012,2,94,9412,PAPUA,MIMIKA,18484,0,16666,1818,0,104,88,629,554,555,455,372,343,3416,2339,0,0,1375,1010,715,5755,0,42,4598,3585,90,571,0,5076,3779,8855,8844
2012,2,94,9410,PAPUA,PANIAI,747,0,198,326,0,0,0,4,4,13,15,45,41,142,133,0,0,8,28,86,275,0,27,275,144,0,14,0,204,193,397,433
2012,2,94,9415,PAPUA,ASMAT,1576,0,220,601,0,21,30,63,67,61,62,45,44,250,174,0,0,181,123,89,424,0,12,378,228,0,217,0,440,377,817,823
2012,2,94,9426,PAPUA,WAROPEN,1187,0,640,0,0,25,15,22,29,16,14,13,26,115,107,0,0,91,30,39,222,0,0,318,14,0,0,0,191,191,382,332
2012,2,94,9402,PAPUA,JAYAWIJAYA,1305,0,1166,139,0,1,3,13,14,8,8,5,5,112,44,0,0,31,16,10,156,0,0,72,137,0,4,0,139,74,213,213
2012,2,94,9411,PAPUA,PUNCAK JAYA,0,0,0,0,0,0,0,0,0,0,0,0,0,0,0,0,0,0,0,0,0,0,0,0,0,0,0,0,0,0,0,0
2012,2,94,9418,PAPUA,TOLIKARA,0,0,0,0,0,0,0,0,0,0,0,0,0,0,0,0,0,0,0,0,0,0,0,0,0,0,0,0,0,0,0,0
2012,2,94,9416,PAPUA,YAHUKIMO,0,0,0,0,0,0,0,0,0,0,0,0,0,0,0,0,0,0,0,0,0,0,0,0,0,0,0,0,0,0,0,0
2012,2,94,9417,PAPUA,PEGUNUNGAN BINTANG,0,0,0,0,0,0,0,0,0,0,0,0,0,0,0,0,0,0,0,0,0,0,0,0,0,0,0,0,0,0,0,0
2012,3,91,9171,PAPUA BARAT,KOTA SORONG,3595,0,3264,86,0,20,29,46,51,68,43,56,36,187,137,0,0,146,111,92,324,0,2,119,555,0,2,0,377,296,673,676
2012,3,91,9107,PAPUA BARAT,SORONG,2144,0,1700,168,0,3,4,22,31,33,24,18,18,74,41,0,0,60,57,36,115,0,1,116,76,0,72,0,150,118,268,264
2012,3,91,9106,PAPUA BARAT,SORONG SELATAN,0,0,0,0,0,0,0,0,0,0,0,0,0,0,0,0,0,0,0,0,0,0,0,0,0,0,0,0,0,0,0,0
2012,3,91,9108,PAPUA BARAT,RAJA AMPAT,340,0,89,132,0,6,5,21,28,14,19,14,13,57,26,0,0,60,33,27,83,0,1,24,154,0,10,0,112,91,203,188
2012,3,91,9105,PAPUA BARAT,MANOKWARI,2317,0,2038,39,0,0,92,63,154,173,70,64,42,36,161,0,0,309,243,106,197,0,0,367,725,0,12,0,336,519,855,1104
2012,3,91,9104,PAPUA BARAT,TELUK BINTUNI,231,0,211,20,0,0,0,0,2,1,2,0,0,11,5,0,0,2,3,0,16,0,0,12,3,0,6,0,12,9,21,21
2012,3,91,9103,PAPUA BARAT,TELUK WONDAMA,1950,0,706,31,0,8,5,43,40,22,22,16,6,46,36,0,0,96,44,22,82,0,7,149,78,0,3,0,135,109,244,230
2012,3,91,9101,PAPUA BARAT,FAKFAK,1516,0,1116,350,0,25,1,67,66,38,40,23,17,64,95,0,0,159,78,40,159,0,9,327,113,0,4,0,217,219,436,444
2012,3,91,9102,PAPUA BARAT,KAIMANA,144,0,144,0,0,0,1,1,2,2,0,1,1,0,2,0,0,4,2,2,2,0,0,6,4,0,0,0,4,6,10,10
2012,3,94,9403,PAPUA,JAYAPURA,7781,0,4218,942,0,32,54,261,215,280,223,138,133,609,639,0,0,562,503,271,1248,0,9,1747,654,15,170,0,1320,1264,2584,2586
2012,3,94,9471,PAPUA,KOTA JAYAPURA,7963,0,7292,671,0,28,29,116,113,163,138,103,111,640,431,0,0,286,301,214,1071,0,18,973,813,2,66,0,1050,822,1872,1854
2012,3,94,9420,PAPUA,KEEROM,5946,0,7234,803,0,17,35,88,232,269,262,184,173,1012,746,0,0,372,531,357,1758,0,21,2098,947,3,158,0,1570,1448,3018,3206
2012,3,94,9419,PAPUA,SARMI,284,0,191,42,0,6,3,26,28,39,41,7,8,23,43,0,0,63,80,15,66,0,4,141,67,0,5,0,101,123,224,213
2012,3,94,9409,PAPUA,BIAK NUMFOR,1969,0,1641,90,0,4,7,35,31,29,32,31,30,79,100,0,0,77,61,61,179,0,13,112,245,0,21,0,178,200,378,378
2012,3,94,9427,PAPUA,SUPIORI,565,0,137,117,0,2,5,10,16,6,4,5,7,28,27,0,0,33,10,12,55,0,0,71,33,0,6,0,51,59,110,110
2012,3,94,9401,PAPUA,MERAUKE,310,0,202,58,0,2,2,10,10,9,8,5,7,22,6,0,0,24,17,12,28,0,0,52,29,0,0,0,48,33,81,81
2012,3,94,9414,PAPUA,MAPPI,1511,0,1160,211,0,12,8,34,34,25,30,10,20,112,131,0,0,88,55,30,243,0,3,179,207,0,30,0,193,223,416,416
2012,3,94,9413,PAPUA,BOVEN DIGOEL,1020,0,634,263,0,18,22,66,47,38,43,14,15,98,95,0,0,153,81,29,193,0,11,288,139,0,39,0,234,222,456,466
2012,3,94,9404,PAPUA,NABIRE,6358,0,3494,709,0,61,47,235,181,163,147,84,73,516,408,0,0,524,310,157,924,0,9,1324,407,1,171,0,1059,856,1915,1903
2012,3,94,9408,PAPUA,KEPULAUAN YAPEN,2287,0,1634,162,0,21,15,81,80,55,53,15,23,107,159,0,0,197,108,38,266,0,24,549,41,0,19,0,279,330,609,609
2012,3,94,9412,PAPUA,MIMIKA,19053,0,11736,216,0,37,37,254,217,249,200,146,121,1153,1052,0,0,545,449,267,2205,0,39,1718,1600,31,117,0,1839,1627,3466,3466
2012,3,94,9410,PAPUA,PANIAI,637,0,267,211,0,1,1,4,4,9,10,23,19,119,110,0,0,10,19,42,229,0,35,166,129,0,0,0,156,144,300,295
2012,3,94,9415,PAPUA,ASMAT,1003,0,169,457,0,29,26,75,84,45,50,30,20,139,128,0,0,214,95,50,267,0,66,315,186,0,123,0,318,308,626,624
2012,3,94,9426,PAPUA,WAROPEN,884,0,475,0,0,7,10,29,28,14,24,15,15,78,94,0,0,74,38,30,172,0,0,256,16,0,0,0,143,171,314,272
2012,3,94,9402,PAPUA,JAYAWIJAYA,905,0,164,741,0,4,2,8,9,3,5,4,3,48,24,0,0,23,8,7,72,0,0,36,64,0,1,0,67,43,110,101
2012,3,94,9411,PAPUA,PUNCAK JAYA,0,0,0,0,0,0,0,0,0,0,0,0,0,0,0,0,0,0,0,0,0,0,0,0,0,0,0,0,0,0,0,0
2012,3,94,9418,PAPUA,TOLIKARA,0,0,0,0,0,0,0,0,0,0,0,0,0,0,0,0,0,0,0,0,0,0,0,0,0,0,0,0,0,0,0,0
2012,3,94,9416,PAPUA,YAHUKIMO,0,0,0,0,0,0,0,0,0,0,0,0,0,0,0,0,0,0,0,0,0,0,0,0,0,0,0,0,0,0,0,0
2012,3,94,9417,PAPUA,PEGUNUNGAN BINTANG,0,0,0,0,0,0,0,0,0,0,0,0,0,0,0,0,0,0,0,0,0,0,0,0,0,0,0,0,0,0,0,0
2012,4,91,9171,PAPUA BARAT,KOTA SORONG,2140,0,2430,53,0,38,16,72,64,55,53,33,35,86,264,0,0,190,108,68,350,0,5,211,299,0,34,0,284,432,716,544
2012,4,91,9107,PAPUA BARAT,SORONG,1870,0,1592,139,0,0,4,14,18,24,21,12,19,59,47,0,0,36,45,31,106,0,1,102,71,0,45,0,109,109,218,218
2012,4,91,9106,PAPUA BARAT,SORONG SELATAN,0,0,0,0,0,0,0,0,0,0,0,0,0,0,0,0,0,0,0,0,0,0,0,0,0,0,0,0,0,0,0,0
2012,4,91,9108,PAPUA BARAT,RAJA AMPAT,641,0,240,259,0,1,2,14,10,40,36,41,104,48,68,0,0,27,76,145,116,0,24,45,299,0,19,0,144,220,364,363
2012,4,91,9105,PAPUA BARAT,MANOKWARI,2625,0,2573,0,0,103,63,180,174,89,108,57,48,222,265,0,0,520,197,105,487,0,6,283,1023,0,0,0,651,658,1309,1306
2012,4,91,9104,PAPUA BARAT,TELUK BINTUNI,199,0,196,3,0,0,0,0,0,1,1,0,0,1,1,0,0,0,2,0,2,0,0,3,1,0,0,0,2,2,4,4
2012,4,91,9103,PAPUA BARAT,TELUK WONDAMA,1226,0,901,18,0,10,7,29,43,21,10,8,12,82,23,0,0,89,31,20,105,0,5,167,80,0,8,0,150,95,245,255
2012,4,91,9101,PAPUA BARAT,FAKFAK,2917,0,2579,287,0,58,49,145,112,87,85,43,39,193,205,0,0,364,172,82,398,0,0,727,243,0,34,0,526,490,1016,1004
2012,4,91,9102,PAPUA BARAT,KAIMANA,389,0,378,0,0,0,1,7,5,2,1,0,1,11,7,0,0,13,3,1,18,0,2,18,17,0,0,0,20,15,35,35
2012,4,94,9403,PAPUA,JAYAPURA,7107,0,4247,516,0,41,20,219,191,253,178,169,136,535,1016,0,0,471,431,305,1551,0,11,1676,491,0,119,0,1217,1541,2758,2286
2012,4,94,9471,PAPUA,KOTA JAYAPURA,8447,0,7768,679,0,27,20,155,113,168,127,107,101,758,528,0,0,315,295,208,1286,0,11,1245,794,10,46,0,1215,889,2104,2095
2012,4,94,9420,PAPUA,KEEROM,8727,0,7397,1330,0,33,30,289,273,337,259,179,171,1117,846,0,0,625,596,350,1963,0,13,2222,1068,0,244,0,1955,1579,3534,3534
2012,4,94,9419,PAPUA,SARMI,544,0,326,12,0,7,11,32,49,25,30,39,28,62,53,0,0,99,55,67,115,0,9,235,97,0,5,0,165,171,336,337
2012,4,94,9409,PAPUA,BIAK NUMFOR,2768,0,2353,184,0,3,18,76,65,80,79,52,53,126,178,0,0,162,159,105,304,0,14,174,529,0,27,0,337,393,730,730
2012,4,94,9427,PAPUA,SUPIORI,839,0,119,38,0,0,1,20,11,18,10,7,8,39,47,0,0,32,28,15,86,0,0,72,85,0,1,0,84,77,161,158
2012,4,94,9401,PAPUA,MERAUKE,940,0,600,257,0,1,3,17,14,17,9,9,8,29,24,0,0,35,26,17,53,0,1,9,120,0,2,0,73,58,131,131
2012,4,94,9414,PAPUA,MAPPI,1397,0,787,413,0,16,16,53,49,43,44,19,23,105,80,0,0,134,87,42,185,0,4,179,244,0,25,0,236,212,448,448
2012,4,94,9413,PAPUA,BOVEN DIGOEL,939,0,512,377,0,26,17,61,61,40,25,10,22,82,127,0,0,165,65,32,209,0,14,277,164,0,32,0,219,252,471,473
2012,4,94,9404,PAPUA,NABIRE,3734,0,2983,348,0,59,51,126,132,120,99,104,89,527,40,0,0,368,219,193,567,0,0,972,601,0,144,0,936,411,1347,1717
2012,4,94,9408,PAPUA,KEPULAUAN YAPEN,502,0,81,241,0,5,4,5,3,5,6,1,3,21,35,0,0,17,11,4,56,0,28,69,5,0,8,0,37,51,88,82
2012,4,94,9412,PAPUA,MIMIKA,15380,0,12905,1534,0,43,43,342,307,325,294,252,210,2088,1596,0,0,735,619,462,3684,0,42,3075,2102,38,340,0,3050,2450,5500,5555
2012,4,94,9410,PAPUA,PANIAI,754,0,185,390,0,8,13,11,20,21,47,56,55,91,45,0,0,52,68,111,136,0,26,179,192,0,12,0,187,180,367,383
2012,4,94,9415,PAPUA,ASMAT,783,0,198,382,0,13,15,71,48,39,36,47,28,126,88,0,0,147,75,75,214,0,11,285,142,0,86,0,296,215,511,513
2012,4,94,9426,PAPUA,WAROPEN,1014,0,576,0,0,7,7,41,20,19,16,11,24,68,102,0,0,75,35,35,170,0,0,288,14,0,0,0,146,169,315,302
2012,4,94,9402,PAPUA,JAYAWIJAYA,1195,0,1043,152,0,3,2,5,8,13,9,5,3,78,53,0,0,18,22,8,131,0,0,69,115,0,0,0,104,75,179,184
2012,4,94,9411,PAPUA,PUNCAK JAYA,0,0,0,0,0,0,0,0,0,0,0,0,0,0,0,0,0,0,0,0,0,0,2,0,0,0,0,0,0,0,0,0
2012,4,94,9418,PAPUA,TOLIKARA,0,0,0,0,0,0,0,0,0,0,0,0,0,0,0,0,0,0,0,0,0,0,0,0,0,0,0,0,0,0,0,0
2012,4,94,9416,PAPUA,YAHUKIMO,0,0,0,0,0,0,0,0,0,0,0,0,0,0,0,0,0,0,0,0,0,0,0,0,0,0,0,0,0,0,0,0
2012,4,94,9417,PAPUA,PEGUNUNGAN BINTANG,0,0,0,0,0,0,0,0,0,0,0,0,0,0,0,0,0,0,0,0,0,0,0,0,0,0,0,0,0,0,0,0
2012,5,91,9171,PAPUA BARAT,KOTA SORONG,2541,0,2482,31,0,8,1,0,0,0,0,0,0,0,0,0,0,9,0,0,0,0,0,137,299,0,3,0,8,1,9,439
2012,5,91,9107,PAPUA BARAT,SORONG,2625,0,2123,64,0,2,1,13,11,15,10,3,7,59,44,0,0,27,25,10,103,0,0,117,62,0,18,0,92,73,165,197
2012,5,91,9106,PAPUA BARAT,SORONG SELATAN,1026,0,1248,23,0,0,0,0,0,0,0,0,0,0,0,0,0,0,0,0,0,0,0,36,640,0,0,0,0,0,0,676
2012,5,91,9108,PAPUA BARAT,RAJA AMPAT,226,0,15,88,0,0,0,0,1,2,2,5,8,37,25,0,0,1,4,13,62,0,0,35,128,0,4,0,44,36,80,167
2012,5,91,9105,PAPUA BARAT,MANOKWARI,3792,0,3792,0,0,53,42,142,150,97,89,64,50,225,361,0,0,387,186,114,586,0,3,905,1172,0,33,0,581,692,1273,2110
2012,5,91,9104,PAPUA BARAT,TELUK BINTUNI,339,0,339,0,0,0,0,0,0,0,0,0,0,0,0,0,0,0,0,0,0,0,0,8,9,0,0,0,0,0,0,17
2012,5,91,9103,PAPUA BARAT,TELUK WONDAMA,1215,0,1204,0,0,8,5,35,36,16,20,9,13,37,45,0,0,84,36,22,82,0,2,144,84,0,2,0,105,119,224,230
2012,5,91,9101,PAPUA BARAT,FAKFAK,2403,0,2403,0,0,3,2,27,16,24,12,5,6,29,29,0,0,48,36,11,58,0,2,725,144,0,2,0,88,65,153,871
2012,5,91,9102,PAPUA BARAT,KAIMANA,1712,0,1275,19,0,3,3,11,9,7,8,11,11,39,43,0,0,26,15,22,82,0,0,133,76,0,11,0,71,74,145,220
2012,5,94,9403,PAPUA,JAYAPURA,8214,0,4567,1006,0,24,17,308,239,283,177,182,181,483,667,0,0,588,460,363,1150,0,17,1771,593,0,278,0,1280,1281,2561,2642
2012,5,94,9471,PAPUA,KOTA JAYAPURA,8348,0,7597,651,0,22,35,174,179,158,175,103,120,992,676,0,0,410,333,223,1668,0,22,1564,939,26,74,0,1449,1185,2634,2603
2012,5,94,9420,PAPUA,KEEROM,9893,0,8902,991,0,24,22,307,270,412,304,287,235,1470,1198,0,0,623,716,522,2668,0,2,2788,1470,1,270,0,2500,2029,4529,4529
2012,5,94,9419,PAPUA,SARMI,405,0,300,11,0,10,11,37,32,35,23,23,20,49,66,0,0,90,58,43,115,0,8,223,87,0,0,0,154,152,306,310
2012,5,94,9409,PAPUA,BIAK NUMFOR,2472,0,2285,97,0,13,29,97,69,76,57,69,63,139,205,0,0,208,133,132,344,0,10,166,626,0,25,0,394,423,817,817
2012,5,94,9427,PAPUA,SUPIORI,822,0,165,25,0,6,4,20,19,13,9,11,6,34,57,0,0,49,22,17,91,0,1,100,76,0,3,0,84,95,179,179
2012,5,94,9401,PAPUA,MERAUKE,1508,0,1148,323,0,10,9,35,40,34,33,22,21,50,49,0,0,94,67,43,99,0,0,23,280,0,1,0,151,152,303,304
2012,5,94,9414,PAPUA,MAPPI,815,0,255,308,0,21,6,35,42,29,23,8,16,59,49,0,0,104,52,24,108,0,1,157,119,8,4,0,152,136,288,288
2012,5,94,9413,PAPUA,BOVEN DIGOEL,2874,0,1365,139,0,35,14,84,66,38,30,15,22,198,203,0,0,199,68,37,401,0,121,404,261,0,32,0,370,335,705,697
2012,5,94,9404,PAPUA,NABIRE,4129,0,3524,605,0,56,55,142,117,123,94,99,93,448,396,0,0,370,217,192,844,0,4,989,503,2,129,0,868,755,1623,1623
2012,5,94,9408,PAPUA,KEPULAUAN YAPEN,1481,0,940,124,0,13,12,47,33,26,22,18,10,58,86,0,0,105,48,28,144,0,22,256,38,0,13,0,162,163,325,307
2012,5,94,9412,PAPUA,MIMIKA,15901,0,14665,1236,0,73,78,419,417,383,360,216,202,2586,1727,0,0,987,743,418,4313,0,23,3501,2539,88,369,0,3677,2784,6461,6497
2012,5,94,9410,PAPUA,PANIAI,746,0,83,663,0,30,32,31,22,33,28,29,27,47,12,0,0,115,61,56,59,0,21,162,175,0,3,0,170,121,291,340
2012,5,94,9415,PAPUA,ASMAT,863,0,204,401,0,21,18,54,56,26,32,25,17,129,114,0,0,149,58,42,243,0,1,274,145,0,77,0,255,237,492,496
2012,5,94,9426,PAPUA,WAROPEN,915,0,520,0,0,10,10,29,23,34,17,18,11,67,83,0,0,72,51,29,150,0,0,274,24,0,0,0,158,144,302,298
2012,5,94,9402,PAPUA,JAYAWIJAYA,282,0,282,0,0,2,1,17,3,6,3,3,3,43,39,0,0,23,9,6,82,0,0,36,83,0,1,0,71,49,120,120
2012,5,94,9411,PAPUA,PUNCAK JAYA,0,0,0,0,0,0,0,0,0,0,0,0,0,0,0,0,0,0,0,0,0,0,0,0,0,0,0,0,0,0,0,0
2012,5,94,9418,PAPUA,TOLIKARA,0,0,0,0,0,0,0,0,0,0,0,0,0,0,0,0,0,0,0,0,0,0,0,0,0,0,0,0,0,0,0,0
2012,5,94,9416,PAPUA,YAHUKIMO,0,0,0,0,0,0,0,0,0,0,0,0,0,0,0,0,0,0,0,0,0,0,0,0,0,0,0,0,0,0,0,0
2012,5,94,9417,PAPUA,PEGUNUNGAN BINTANG,0,0,0,0,0,0,0,0,0,0,0,0,0,0,0,0,0,0,0,0,0,0,0,0,0,0,0,0,0,0,0,0
2012,6,91,9171,PAPUA BARAT,KOTA SORONG,2054,0,1803,39,0,15,10,51,43,33,27,23,16,102,103,0,0,119,60,39,205,0,2,121,300,0,7,0,224,199,423,428
2012,6,91,9107,PAPUA BARAT,SORONG,1883,0,1719,69,0,3,2,25,19,22,16,10,7,62,48,0,0,49,38,17,110,0,0,148,45,0,21,0,122,92,214,214
2012,6,91,9106,PAPUA BARAT,SORONG SELATAN,1528,0,1436,30,0,32,25,66,59,31,32,18,16,121,159,0,0,182,63,34,280,0,0,26,541,0,1,0,268,291,559,568
2012,6,91,9108,PAPUA BARAT,RAJA AMPAT,1676,0,384,899,0,4,14,37,31,55,94,57,93,241,170,0,0,86,149,150,411,0,0,49,719,0,0,0,394,402,796,768
2012,6,91,9105,PAPUA BARAT,MANOKWARI,3043,0,2396,0,0,105,97,225,204,116,88,58,53,284,350,0,0,631,204,111,634,0,3,485,1056,0,6,0,788,792,1580,1547
2012,6,91,9104,PAPUA BARAT,TELUK BINTUNI,216,0,216,0,0,0,0,1,2,0,0,0,0,1,1,0,0,3,0,0,2,0,0,5,0,0,0,0,2,3,5,5
2012,6,91,9103,PAPUA BARAT,TELUK WONDAMA,1151,0,1123,50,0,7,10,53,34,19,17,7,9,56,44,0,0,104,36,16,100,0,11,137,108,0,6,0,142,114,256,251
2012,6,91,9101,PAPUA BARAT,FAKFAK,1635,0,1635,141,0,26,18,79,76,48,40,18,22,105,126,0,0,199,88,40,231,0,2,452,114,0,0,0,276,282,558,566
2012,6,91,9102,PAPUA BARAT,KAIMANA,585,0,511,74,0,1,1,9,2,4,8,6,5,25,30,0,0,13,12,11,55,0,0,69,11,0,11,0,45,46,91,91
2012,6,94,9403,PAPUA,JAYAPURA,7921,0,4529,993,0,35,32,252,251,284,214,130,141,556,489,0,0,570,498,271,1045,0,10,1681,570,1,132,0,1257,1127,2384,2384
2012,6,94,9471,PAPUA,KOTA JAYAPURA,12548,0,6492,581,0,23,25,147,142,143,143,80,102,733,521,0,0,337,286,182,1254,0,5,1150,821,10,47,0,1126,933,2059,2028
2012,6,94,9420,PAPUA,KEEROM,7794,0,7529,265,0,22,27,297,257,313,255,191,176,1311,1086,0,0,603,568,367,2397,0,7,2435,1244,1,256,0,2134,1801,3935,3936
2012,6,94,9419,PAPUA,SARMI,0,0,0,0,0,0,0,0,0,0,0,0,0,0,0,0,0,0,0,0,0,0,0,0,0,0,0,0,0,0,0,0
2012,6,94,9409,PAPUA,BIAK NUMFOR,338,0,318,66,0,1,1,13,11,3,7,8,14,46,101,0,0,26,10,22,147,0,0,23,38,0,3,0,71,134,205,64
2012,6,94,9427,PAPUA,SUPIORI,262,0,139,23,0,8,5,7,5,7,5,3,3,43,42,0,0,25,12,6,85,0,0,65,63,0,0,0,68,60,128,128
2012,6,94,9401,PAPUA,MERAUKE,232,0,182,278,0,0,0,2,2,1,2,0,25,77,74,0,0,4,3,25,151,0,0,3,9,2,0,0,80,103,183,14
2012,6,94,9414,PAPUA,MAPPI,1613,0,840,716,0,8,6,32,35,30,32,7,7,52,39,0,0,81,62,14,91,0,0,160,79,2,8,0,129,119,248,249
2012,6,94,9413,PAPUA,BOVEN DIGOEL,1651,0,651,270,0,7,9,33,38,21,19,6,17,64,87,0,0,87,40,23,151,0,10,217,72,0,21,0,131,170,301,310
2012,6,94,9404,PAPUA,NABIRE,3517,0,2464,405,0,61,48,135,118,96,83,76,71,483,491,0,0,362,179,147,974,0,5,996,479,0,186,0,851,811,1662,1661
2012,6,94,9408,PAPUA,KEPULAUAN YAPEN,289,0,0,61,0,10,9,32,16,24,16,8,10,33,69,0,0,67,40,18,102,0,15,184,34,0,6,0,107,120,227,224
2012,6,94,9412,PAPUA,MIMIKA,11980,0,11570,1945,0,92,98,468,428,452,373,310,281,3505,2216,0,0,1086,825,591,5721,0,21,4288,3220,150,591,0,4827,3396,8223,8249
2012,6,94,9410,PAPUA,PANIAI,0,0,0,0,0,0,0,0,0,0,0,0,19,79,59,0,0,0,0,19,138,0,29,0,0,0,0,0,79,78,157,0
2012,6,94,9415,PAPUA,ASMAT,64,0,0,64,0,2,3,8,9,3,3,2,5,79,31,0,0,22,6,7,110,0,2,37,37,0,8,0,94,51,145,82
2012,6,94,9426,PAPUA,WAROPEN,505,0,323,0,0,2,1,11,16,6,10,7,5,37,46,0,0,30,16,12,83,0,0,102,39,0,0,0,63,78,141,141
2012,6,94,9402,PAPUA,JAYAWIJAYA,759,0,750,9,0,2,0,9,7,7,6,5,9,50,42,0,0,18,13,14,92,0,0,53,85,0,0,0,73,64,137,138
2012,6,94,9411,PAPUA,PUNCAK JAYA,0,0,0,0,0,0,0,0,0,0,0,0,0,0,0,0,0,0,0,0,0,0,0,0,0,0,0,0,0,0,0,0
2012,6,94,9418,PAPUA,TOLIKARA,0,0,0,0,0,0,0,0,0,0,0,0,0,0,0,0,0,0,0,0,0,0,0,0,0,0,0,0,0,0,0,0
2012,6,94,9416,PAPUA,YAHUKIMO,0,0,0,0,0,0,0,0,0,0,0,0,0,0,0,0,0,0,0,0,0,0,0,0,0,0,0,0,0,0,0,0
2012,6,94,9417,PAPUA,PEGUNUNGAN BINTANG,0,0,0,0,0,0,0,0,0,0,0,0,0,0,0,0,0,0,0,0,0,0,0,0,0,0,0,0,0,0,0,0
2012,7,91,9171,PAPUA BARAT,KOTA SORONG,2535,0,2445,17,0,9,7,22,19,25,10,14,10,57,47,0,0,57,35,24,104,0,0,136,271,0,1,0,127,93,220,408
2012,7,91,9107,PAPUA BARAT,SORONG,2056,0,1546,55,0,1,1,10,12,9,9,5,3,70,34,0,0,24,18,8,104,0,0,101,38,0,15,0,95,59,154,154
2012,7,91,9106,PAPUA BARAT,SORONG SELATAN,1080,0,1059,21,0,0,0,0,0,1,2,0,0,3,5,0,0,0,3,0,8,0,1,59,430,0,1,0,4,7,11,490
2012,7,91,9108,PAPUA BARAT,RAJA AMPAT,230,0,116,46,0,1,0,11,10,12,14,11,12,18,21,0,0,22,26,23,39,0,1,19,57,0,9,0,53,57,110,85
2012,7,91,9105,PAPUA BARAT,MANOKWARI,4328,0,3731,249,0,145,124,305,313,148,138,118,107,481,741,0,0,887,286,225,1222,0,3,989,1512,0,28,0,1197,1423,2620,2529
2012,7,91,9104,PAPUA BARAT,TELUK BINTUNI,152,0,110,42,0,0,0,1,0,1,1,0,2,3,7,0,0,1,2,2,10,0,1,10,3,0,2,0,5,10,15,15
2012,7,91,9103,PAPUA BARAT,TELUK WONDAMA,957,0,522,3,0,19,17,42,35,14,12,5,5,71,54,0,0,113,26,10,125,0,3,179,79,0,10,0,151,123,274,268
2012,7,91,9101,PAPUA BARAT,FAKFAK,3154,0,3137,13,0,51,48,131,124,69,45,27,24,140,159,0,0,354,114,51,299,0,47,657,157,0,7,0,418,400,818,821
2012,7,91,9102,PAPUA BARAT,KAIMANA,835,0,580,65,0,4,5,10,9,8,3,5,5,42,25,0,0,28,11,10,67,0,0,73,32,0,11,0,69,47,116,116
2012,7,94,9403,PAPUA,JAYAPURA,6488,0,4136,439,0,35,31,193,198,174,140,117,85,469,438,0,0,457,314,202,907,0,1,1253,518,0,109,0,988,892,1880,1880
2012,7,94,9471,PAPUA,KOTA JAYAPURA,4421,0,4325,96,0,15,14,104,105,88,75,45,42,311,270,0,0,238,163,87,581,0,20,654,343,0,32,0,563,506,1069,1029
2012,7,94,9420,PAPUA,KEEROM,6114,0,6005,109,0,13,31,222,203,179,177,158,157,989,644,0,0,469,356,315,1633,0,50,1753,847,0,173,0,1561,1212,2773,2773
2012,7,94,9419,PAPUA,SARMI,1068,0,975,68,0,16,8,48,67,43,35,12,12,81,97,0,0,139,78,24,178,0,0,351,62,0,6,0,200,219,419,419
2012,7,94,9409,PAPUA,BIAK NUMFOR,1658,0,1445,59,0,11,10,41,46,38,33,16,35,74,119,0,0,108,71,51,193,0,0,91,308,0,24,0,180,243,423,423
2012,7,94,9427,PAPUA,SUPIORI,507,0,75,25,0,3,5,3,8,7,3,8,5,21,14,0,0,19,10,13,35,0,2,16,38,0,20,0,42,35,77,74
2012,7,94,9401,PAPUA,MERAUKE,396,0,225,170,0,3,4,15,14,6,4,6,7,20,14,0,0,36,10,13,34,0,0,4,89,0,1,0,50,43,93,94
2012,7,94,9414,PAPUA,MAPPI,1071,0,546,525,0,2,4,24,24,17,12,9,5,28,27,0,0,54,29,14,55,0,0,135,14,0,4,0,80,72,152,153
2012,7,94,9413,PAPUA,BOVEN DIGOEL,1376,0,955,421,0,23,15,61,60,23,25,11,15,113,143,0,0,159,48,26,256,0,0,236,157,0,10,0,231,258,489,403
2012,7,94,9404,PAPUA,NABIRE,3318,0,2052,247,0,45,36,134,111,73,66,77,52,424,390,0,0,326,139,129,814,0,0,776,448,1,129,0,753,655,1408,1354
2012,7,94,9408,PAPUA,KEPULAUAN YAPEN,1835,0,1704,131,0,58,44,58,64,52,48,44,39,136,155,0,0,224,100,83,291,0,58,952,36,0,9,0,348,350,698,997
2012,7,94,9412,PAPUA,MIMIKA,14801,0,13983,818,0,102,97,595,534,468,404,329,302,2762,2220,0,0,1328,872,631,4982,0,19,4309,2978,76,450,0,4256,3557,7813,7813
2012,7,94,9410,PAPUA,PANIAI,821,0,134,497,0,0,9,22,25,22,35,37,35,77,62,0,0,56,57,72,139,0,0,162,182,0,0,0,158,166,324,344
2012,7,94,9415,PAPUA,ASMAT,962,0,158,587,0,28,24,125,106,61,61,37,31,258,223,0,0,283,122,68,481,0,0,499,262,0,170,0,509,445,954,931
2012,7,94,9426,PAPUA,WAROPEN,727,0,727,0,0,16,8,46,29,20,29,26,22,120,127,0,0,99,49,48,247,0,0,396,32,0,0,0,228,215,443,428
2012,7,94,9402,PAPUA,JAYAWIJAYA,866,0,860,6,0,5,7,21,21,6,6,3,6,78,63,0,0,54,12,9,141,0,0,63,101,0,0,0,113,103,216,164
2012,7,94,9411,PAPUA,PUNCAK JAYA,0,0,0,0,0,0,0,0,0,0,0,0,0,0,0,0,0,0,0,0,0,0,0,0,0,0,0,0,0,0,0,0
2012,7,94,9418,PAPUA,TOLIKARA,0,0,0,0,0,0,0,0,0,0,0,0,0,0,0,0,0,0,0,0,0,0,0,0,0,0,0,0,0,0,0,0
2012,7,94,9416,PAPUA,YAHUKIMO,0,0,0,0,0,0,0,0,0,0,0,0,0,0,0,0,0,0,0,0,0,0,0,0,0,0,0,0,0,0,0,0
2012,7,94,9417,PAPUA,PEGUNUNGAN BINTANG,0,0,0,0,0,0,0,0,0,0,0,0,0,0,0,0,0,0,0,0,0,0,0,0,0,0,0,0,0,0,0,0
2012,8,91,9171,PAPUA BARAT,KOTA SORONG,2728,0,2049,65,0,5,4,16,15,32,18,20,11,44,28,0,0,40,50,31,72,0,0,129,295,0,5,0,117,76,193,429
2012,8,91,9107,PAPUA BARAT,SORONG,1589,0,1219,16,0,3,0,10,10,10,5,7,6,47,29,0,0,23,15,13,76,0,0,85,35,0,6,0,77,50,127,126
2012,8,91,9106,PAPUA BARAT,SORONG SELATAN,1406,0,1320,25,0,41,49,75,98,59,71,21,35,148,179,0,0,263,130,56,327,0,0,28,659,0,1,0,344,432,776,688
2012,8,91,9108,PAPUA BARAT,RAJA AMPAT,230,0,116,46,0,1,0,10,10,8,6,6,9,16,19,0,0,21,14,15,35,0,1,19,57,0,9,0,41,44,85,85
2012,8,91,9105,PAPUA BARAT,MANOKWARI,3886,0,3102,221,0,116,81,199,185,98,80,68,57,332,394,0,0,581,178,125,726,0,5,552,986,0,43,0,813,797,1610,1581
2012,8,91,9104,PAPUA BARAT,TELUK BINTUNI,180,0,115,65,0,0,1,4,2,2,0,2,0,17,13,0,0,7,2,2,30,0,0,19,12,0,10,0,25,16,41,41
2012,8,91,9103,PAPUA BARAT,TELUK WONDAMA,894,0,853,4,0,6,8,34,24,16,15,12,13,87,51,0,0,72,31,25,138,0,2,153,105,0,8,0,155,111,266,266
2012,8,91,9101,PAPUA BARAT,FAKFAK,2530,0,2228,9,0,36,30,153,132,100,86,65,66,185,200,0,0,351,186,131,385,0,5,765,325,0,5,0,539,514,1053,1095
2012,8,91,9102,PAPUA BARAT,KAIMANA,956,0,678,48,0,3,4,9,11,11,5,9,4,26,29,0,0,27,16,13,55,0,0,76,31,0,4,0,58,53,111,111
2012,8,94,9403,PAPUA,JAYAPURA,4855,0,3163,211,0,24,40,150,152,147,132,81,77,407,367,0,0,366,279,158,774,0,0,932,453,1,71,0,809,768,1577,1457
2012,8,94,9471,PAPUA,KOTA JAYAPURA,3507,0,3387,27,0,18,22,108,108,110,122,76,82,548,408,0,0,256,232,158,956,0,5,537,257,1,31,0,860,742,1602,826
2012,8,94,9420,PAPUA,KEEROM,3478,0,3370,108,0,18,21,150,131,122,91,68,55,449,346,0,0,320,213,123,795,0,17,928,420,1,75,0,807,644,1451,1424
2012,8,94,9419,PAPUA,SARMI,1079,0,953,73,0,0,0,0,0,0,0,0,0,0,0,0,0,0,0,0,0,0,0,313,73,0,8,0,0,0,0,394
2012,8,94,9409,PAPUA,BIAK NUMFOR,1401,0,1180,94,0,3,1,16,10,10,10,13,6,23,42,0,0,30,20,19,65,0,0,102,205,0,5,0,65,69,134,312
2012,8,94,9427,PAPUA,SUPIORI,395,0,94,55,0,0,0,0,0,0,0,0,0,0,0,0,0,0,0,0,0,0,0,76,51,0,22,0,0,0,0,149
2012,8,94,9401,PAPUA,MERAUKE,426,0,298,110,0,3,6,23,15,16,8,11,16,25,31,0,0,47,24,27,56,0,0,0,154,0,0,0,78,76,154,154
2012,8,94,9414,PAPUA,MAPPI,741,0,507,234,0,5,1,26,24,11,14,9,7,27,37,0,0,56,25,16,64,0,24,126,28,0,7,0,78,83,161,161
2012,8,94,9413,PAPUA,BOVEN DIGOEL,1585,0,942,157,0,0,0,0,0,0,0,0,0,0,0,0,0,0,0,0,0,0,0,215,107,0,18,0,0,0,0,340
2012,8,94,9404,PAPUA,NABIRE,4813,0,3403,513,0,48,47,179,144,111,87,100,86,495,481,0,0,418,198,186,976,0,38,931,696,11,161,0,933,845,1778,1799
2012,8,94,9408,PAPUA,KEPULAUAN YAPEN,1689,0,1487,142,0,19,23,25,10,9,8,5,5,21,46,0,0,77,17,10,67,0,14,931,25,0,8,0,79,92,171,964
2012,8,94,9412,PAPUA,MIMIKA,17887,0,17533,347,0,16,17,71,102,98,74,82,53,1276,583,0,0,206,172,135,1859,0,0,4742,3055,108,251,0,1543,829,2372,8156
2012,8,94,9410,PAPUA,PANIAI,0,0,0,0,0,0,0,0,0,0,0,0,0,0,0,0,0,0,0,0,0,0,0,0,0,0,0,0,0,0,0,0
2012,8,94,9415,PAPUA,ASMAT,1125,0,81,639,0,0,0,0,0,0,0,0,0,0,0,0,0,0,0,0,0,0,0,496,81,0,148,0,0,0,0,725
2012,8,94,9426,PAPUA,WAROPEN,833,0,422,17,0,0,0,0,0,0,0,0,0,0,0,0,0,0,0,0,0,0,0,187,64,0,0,0,0,0,0,251
2012,8,94,9402,PAPUA,JAYAWIJAYA,461,0,430,31,0,0,0,0,0,0,0,0,0,0,0,0,0,0,0,0,0,0,0,52,74,0,0,0,0,0,0,126
2012,8,94,9411,PAPUA,PUNCAK JAYA,0,0,0,0,0,0,0,0,0,0,0,0,0,0,0,0,0,0,0,0,0,0,0,0,0,0,0,0,0,0,0,0
2012,8,94,9418,PAPUA,TOLIKARA,0,0,0,0,0,0,0,0,0,0,0,0,0,0,0,0,0,0,0,0,0,0,0,0,0,0,0,0,0,0,0,0
2012,8,94,9416,PAPUA,YAHUKIMO,0,0,0,0,0,0,0,0,0,0,0,0,0,0,0,0,0,0,0,0,0,0,0,0,0,0,0,0,0,0,0,0
2012,8,94,9417,PAPUA,PEGUNUNGAN BINTANG,0,0,0,0,0,0,0,0,0,0,0,0,0,0,0,0,0,0,0,0,0,0,0,0,0,0,0,0,0,0,0,0
2012,9,91,9171,PAPUA BARAT,KOTA SORONG,2329,0,2250,60,0,17,12,34,24,18,21,28,20,56,89,0,0,87,39,48,145,0,3,144,210,0,3,0,153,166,319,357
2012,9,91,9107,PAPUA BARAT,SORONG,1705,0,1293,64,0,1,2,7,18,23,13,7,10,35,27,0,0,28,36,17,62,0,0,77,36,0,30,0,73,70,143,143
2012,9,91,9106,PAPUA BARAT,SORONG SELATAN,1088,0,966,111,0,28,30,81,92,43,42,41,146,90,114,0,0,231,85,187,204,0,0,176,421,0,0,0,283,424,707,597
2012,9,91,9108,PAPUA BARAT,RAJA AMPAT,230,0,116,46,0,1,0,10,10,8,6,6,9,16,19,0,0,21,14,15,35,0,1,19,57,0,9,0,41,44,85,85
2012,9,91,9105,PAPUA BARAT,MANOKWARI,3666,0,3420,246,0,86,59,186,186,88,98,75,68,361,414,0,0,517,186,143,775,0,3,449,1220,0,23,0,796,825,1621,1692
2012,9,91,9104,PAPUA BARAT,TELUK BINTUNI,230,0,172,63,0,0,0,1,5,6,0,0,0,5,3,0,0,6,6,0,8,0,0,9,10,0,1,0,12,8,20,20
2012,9,91,9103,PAPUA BARAT,TELUK WONDAMA,1009,0,979,0,0,16,5,38,35,16,13,10,5,84,42,0,0,94,29,15,126,0,0,160,96,0,8,0,164,100,264,264
2012,9,91,9101,PAPUA BARAT,FAKFAK,3536,0,3440,12,0,30,34,162,131,71,70,32,36,150,141,0,0,357,141,68,291,0,31,777,151,3,2,0,445,412,857,933
2012,9,91,9102,PAPUA BARAT,KAIMANA,821,0,639,54,0,4,2,11,7,6,4,0,4,28,22,0,0,24,10,4,50,0,0,61,24,0,3,0,49,39,88,88
2012,9,94,9403,PAPUA,JAYAPURA,6039,0,3780,911,0,23,44,167,164,173,166,127,84,396,363,0,0,398,339,211,759,0,0,1072,532,2,99,0,886,821,1707,1705
2012,9,94,9471,PAPUA,KOTA JAYAPURA,3695,0,3661,494,0,12,27,120,124,139,138,98,93,469,415,0,0,283,277,191,884,0,7,940,633,4,51,0,838,797,1635,1628
2012,9,94,9420,PAPUA,KEEROM,5493,0,5410,462,0,31,24,269,239,303,248,233,180,1132,843,0,0,563,551,413,1975,0,16,1959,1273,0,274,0,1968,1534,3502,3506
2012,9,94,9419,PAPUA,SARMI,1123,0,1021,0,0,9,5,38,39,33,28,20,17,76,85,0,0,91,61,37,161,0,1,271,71,0,7,0,176,174,350,349
2012,9,94,9409,PAPUA,BIAK NUMFOR,1574,0,1497,13,0,5,8,24,30,11,24,10,12,36,63,0,0,67,35,22,99,0,0,46,173,0,4,0,86,137,223,223
2012,9,94,9427,PAPUA,SUPIORI,666,0,66,0,0,0,0,0,0,0,0,0,0,0,0,0,0,0,0,0,0,0,0,0,0,0,0,0,0,0,0,0
2012,9,94,9401,PAPUA,MERAUKE,0,0,0,0,0,0,0,0,0,0,0,0,0,0,0,0,0,0,0,0,0,0,0,0,0,0,0,0,0,0,0,0
2012,9,94,9414,PAPUA,MAPPI,1169,0,739,409,0,7,11,41,49,30,28,16,6,58,45,0,0,108,58,22,103,0,21,229,36,0,126,0,152,139,291,391
2012,9,94,9413,PAPUA,BOVEN DIGOEL,2233,0,1061,219,0,19,12,56,62,29,40,18,23,122,152,0,0,149,69,41,274,0,16,226,291,0,16,0,244,289,533,533
2012,9,94,9404,PAPUA,NABIRE,3073,0,2345,190,0,48,39,139,118,105,89,71,72,341,380,0,0,344,194,143,721,0,0,757,538,1,92,0,704,698,1402,1388
2012,9,94,9408,PAPUA,KEPULAUAN YAPEN,4044,0,2424,56,0,38,23,92,109,69,66,38,29,151,268,0,0,262,135,67,419,0,50,828,51,0,4,0,388,495,883,883
2012,9,94,9412,PAPUA,MIMIKA,16639,0,16316,825,0,62,61,398,359,436,346,314,212,2946,1894,0,0,880,782,526,4840,0,68,3629,3138,43,241,0,4156,2872,7028,7051
2012,9,94,9410,PAPUA,PANIAI,0,0,0,0,0,0,0,0,0,0,0,0,0,0,0,0,0,0,0,0,0,0,0,0,0,0,0,0,0,0,0,0
2012,9,94,9415,PAPUA,ASMAT,661,0,91,0,0,0,0,0,0,0,0,0,0,0,0,0,0,0,0,0,0,0,0,0,0,0,0,0,0,0,0,0
2012,9,94,9426,PAPUA,WAROPEN,841,0,453,0,0,0,0,0,0,0,0,0,0,0,0,0,0,0,0,0,0,0,0,0,0,0,0,0,0,0,0,0
2012,9,94,9402,PAPUA,JAYAWIJAYA,724,0,678,34,0,1,2,5,5,5,3,4,3,51,58,0,0,13,8,7,109,0,0,38,77,0,2,0,66,71,137,117
2012,9,94,9411,PAPUA,PUNCAK JAYA,0,0,0,0,0,0,0,0,0,0,0,0,0,0,0,0,0,0,0,0,0,0,0,0,0,0,0,0,0,0,0,0
2012,9,94,9418,PAPUA,TOLIKARA,0,0,0,0,0,0,0,0,0,0,0,0,0,0,0,0,0,0,0,0,0,0,0,0,0,0,0,0,0,0,0,0
2012,9,94,9416,PAPUA,YAHUKIMO,0,0,0,0,0,0,0,0,0,0,0,0,0,0,0,0,0,0,0,0,0,0,0,0,0,0,0,0,0,0,0,0
2012,9,94,9417,PAPUA,PEGUNUNGAN BINTANG,0,0,0,0,0,0,0,0,0,0,0,0,0,0,0,0,0,0,0,0,0,0,0,0,0,0,0,0,0,0,0,0
2012,10,91,9171,PAPUA BARAT,KOTA SORONG,1630,0,1630,0,0,16,12,54,50,50,40,33,29,90,93,0,0,132,90,62,183,0,0,177,280,0,0,0,243,224,467,457
2012,10,91,9107,PAPUA BARAT,SORONG,2049,0,1671,0,0,1,1,7,6,5,3,6,3,20,33,0,0,15,8,9,53,0,0,63,20,0,1,0,39,46,85,84
2012,10,91,9106,PAPUA BARAT,SORONG SELATAN,1589,0,1527,62,0,69,76,136,167,74,107,32,34,159,218,0,0,448,181,66,377,0,0,34,1034,3,1,0,470,602,1072,1072
2012,10,91,9108,PAPUA BARAT,RAJA AMPAT,230,0,116,46,0,1,0,10,10,8,6,6,9,16,19,0,0,21,14,15,35,0,1,19,57,0,9,0,41,44,85,85
2012,10,91,9105,PAPUA BARAT,MANOKWARI,4095,0,3542,310,0,74,75,196,173,112,112,103,68,288,367,0,0,518,224,171,655,0,3,657,903,0,17,0,773,795,1568,1577
2012,10,91,9104,PAPUA BARAT,TELUK BINTUNI,344,0,257,94,0,0,0,3,3,4,1,4,3,16,17,0,0,6,5,7,33,0,0,34,9,0,8,0,27,24,51,51
2012,10,91,9103,PAPUA BARAT,TELUK WONDAMA,1182,0,1157,7,0,6,12,48,35,28,22,13,12,78,50,0,0,101,50,25,128,0,0,212,83,2,7,0,173,131,304,304
2012,10,91,9101,PAPUA BARAT,FAKFAK,3098,0,2896,138,0,16,24,100,67,70,69,76,55,143,149,0,0,207,139,131,292,0,16,579,184,0,7,0,405,364,769,770
2012,10,91,9102,PAPUA BARAT,KAIMANA,1035,0,800,87,0,7,3,12,12,8,7,2,1,50,17,0,0,34,15,3,67,0,0,80,30,0,9,0,79,40,119,119
2012,10,94,9403,PAPUA,JAYAPURA,1813,0,3756,384,0,25,21,180,176,173,157,103,68,455,394,0,0,402,330,171,849,0,0,1152,540,2,58,0,936,816,1752,1752
2012,10,94,9471,PAPUA,KOTA JAYAPURA,4618,0,4536,82,0,9,13,72,67,73,76,47,30,255,185,0,0,161,149,77,440,0,0,495,266,9,34,0,456,371,827,804
2012,10,94,9420,PAPUA,KEEROM,3158,0,3044,114,0,9,15,137,114,109,85,74,67,379,268,0,0,275,194,141,647,0,6,658,493,0,107,0,708,549,1257,1258
2012,10,94,9419,PAPUA,SARMI,1157,0,915,0,0,7,4,44,32,31,22,15,15,61,59,0,0,87,53,30,120,0,30,337,88,0,6,0,158,132,290,431
2012,10,94,9409,PAPUA,BIAK NUMFOR,1679,0,1514,49,0,5,8,24,25,23,22,14,16,48,65,0,0,62,45,30,113,0,0,67,180,0,3,0,114,136,250,250
2012,10,94,9427,PAPUA,SUPIORI,387,0,77,22,0,0,4,10,15,6,16,6,8,19,17,0,0,29,22,14,36,0,0,70,42,0,7,0,41,60,101,119
2012,10,94,9401,PAPUA,MERAUKE,466,0,388,77,0,7,8,26,25,11,11,5,6,31,25,0,0,66,22,11,56,0,0,36,119,0,0,0,80,75,155,155
2012,10,94,9414,PAPUA,MAPPI,1532,0,872,648,0,15,23,80,56,43,27,19,26,94,92,0,0,174,70,45,186,0,0,273,111,2,31,0,251,224,475,417
2012,10,94,9413,PAPUA,BOVEN DIGOEL,3212,0,891,183,0,12,9,71,54,36,29,12,22,92,109,0,0,146,65,34,201,0,10,238,195,0,15,0,223,223,446,448
2012,10,94,9404,PAPUA,NABIRE,2046,0,2572,257,0,53,54,156,140,91,100,54,68,393,383,0,0,403,191,122,776,0,7,751,486,5,154,0,747,745,1492,1396
2012,10,94,9408,PAPUA,KEPULAUAN YAPEN,13552,0,1920,126,0,39,21,81,61,77,53,27,23,102,155,0,0,202,130,50,257,0,0,489,45,0,5,0,326,313,639,539
2012,10,94,9412,PAPUA,MIMIKA,13552,0,13306,246,0,87,85,428,367,428,363,306,279,2554,1924,0,0,967,791,585,4478,0,0,3794,2582,61,398,0,3803,3018,6821,6835
2012,10,94,9410,PAPUA,PANIAI,0,0,0,0,0,0,0,0,0,0,0,0,0,0,0,0,0,0,0,0,0,0,0,0,0,0,0,0,0,0,0,0
2012,10,94,9415,PAPUA,ASMAT,808,0,99,281,0,13,14,45,40,15,18,22,9,111,88,0,0,112,33,31,199,0,0,0,0,0,0,0,206,169,375,0
2012,10,94,9426,PAPUA,WAROPEN,1702,0,891,22,0,20,7,63,54,32,34,20,17,122,129,0,0,144,66,37,251,0,0,194,128,0,53,0,257,241,498,375
2012,10,94,9402,PAPUA,JAYAWIJAYA,748,0,706,42,0,2,1,9,9,4,4,7,1,38,30,0,0,21,8,8,68,0,0,408,27,0,0,0,60,45,105,435
2012,10,94,9411,PAPUA,PUNCAK JAYA,0,0,0,0,0,0,0,0,0,0,0,0,0,0,0,0,0,0,0,0,0,0,0,48,57,0,0,0,0,0,0,105
2012,10,94,9418,PAPUA,TOLIKARA,0,0,0,0,0,0,0,0,0,0,0,0,0,0,0,0,0,0,0,0,0,0,0,0,0,0,0,0,0,0,0,0
2012,10,94,9416,PAPUA,YAHUKIMO,0,0,0,0,0,0,0,0,0,0,0,0,0,0,0,0,0,0,0,0,0,0,0,0,0,0,0,0,0,0,0,0
2012,10,94,9417,PAPUA,PEGUNUNGAN BINTANG,0,0,0,0,0,0,0,0,0,0,0,0,0,0,0,0,0,0,0,0,0,0,0,0,0,0,0,0,0,0,0,0
2012,11,91,9171,PAPUA BARAT,KOTA SORONG,1733,0,1694,15,0,20,24,60,40,38,36,30,15,77,59,0,0,144,74,45,136,0,0,129,270,0,1,0,225,174,399,400
2012,11,91,9107,PAPUA BARAT,SORONG,1715,0,1258,57,0,1,1,8,7,4,5,0,4,24,24,0,0,17,9,4,48,0,0,47,30,0,1,0,37,41,78,78
2012,11,91,9106,PAPUA BARAT,SORONG SELATAN,1753,0,1381,353,0,63,67,152,160,87,85,31,38,182,193,0,0,442,172,69,375,0,0,117,930,0,2,0,515,543,1058,1049
2012,11,91,9108,PAPUA BARAT,RAJA AMPAT,270,0,98,83,0,0,0,2,7,7,7,13,11,43,55,0,0,9,14,24,98,0,0,5,140,0,3,0,65,80,145,148
2012,11,91,9105,PAPUA BARAT,MANOKWARI,3166,0,2613,326,0,57,54,178,143,84,90,70,55,235,293,0,0,432,174,125,528,0,3,318,887,0,35,0,624,635,1259,1240
2012,11,91,9104,PAPUA BARAT,TELUK BINTUNI,372,0,336,26,0,0,0,2,4,4,2,2,5,9,3,0,0,6,6,7,12,0,0,16,15,0,0,0,17,14,31,31
2012,11,91,9103,PAPUA BARAT,TELUK WONDAMA,762,0,743,7,0,12,7,46,25,14,16,6,7,72,30,0,0,90,30,13,102,0,0,139,88,0,8,0,150,85,235,235
2012,11,91,9101,PAPUA BARAT,FAKFAK,3881,0,3687,192,0,25,23,188,154,137,132,143,133,286,278,0,0,390,269,276,564,0,18,1098,390,0,1,0,779,720,1499,1489
2012,11,91,9102,PAPUA BARAT,KAIMANA,992,0,798,64,0,6,4,19,19,9,13,8,0,40,32,0,0,48,22,8,72,0,0,101,37,0,14,0,82,68,150,152
2012,11,94,9403,PAPUA,JAYAPURA,6103,0,4242,364,0,18,17,182,150,144,127,101,85,335,334,0,0,367,271,186,669,0,0,957,465,5,69,0,780,713,1493,1496
2012,11,94,9471,PAPUA,KOTA JAYAPURA,4530,0,4434,96,0,15,14,104,105,88,75,45,41,305,275,0,0,238,163,86,580,0,0,656,353,0,32,0,557,510,1067,1041
2012,11,94,9420,PAPUA,KEEROM,5182,0,4874,308,0,10,8,143,145,164,154,110,100,939,447,0,0,306,318,210,1386,0,47,1023,834,1,86,0,1366,854,2220,1944
2012,11,94,9419,PAPUA,SARMI,919,0,777,0,0,5,5,46,39,38,33,29,15,66,72,0,0,95,71,44,138,0,0,276,69,0,3,0,184,164,348,348
2012,11,94,9409,PAPUA,BIAK NUMFOR,1449,0,1248,163,0,2,4,22,25,13,20,19,16,16,24,0,0,53,33,35,40,0,0,64,97,0,3,0,72,89,161,164
2012,11,94,9427,PAPUA,SUPIORI,409,0,54,65,0,4,2,7,7,2,7,7,3,45,36,0,0,20,9,10,81,0,0,50,58,0,11,0,65,55,120,119
2012,11,94,9401,PAPUA,MERAUKE,0,0,0,0,0,0,0,0,0,0,0,0,0,0,0,0,0,0,0,0,0,0,0,0,0,0,0,0,0,0,0,0
2012,11,94,9414,PAPUA,MAPPI,1389,0,564,825,0,19,19,67,70,48,34,22,17,79,46,0,0,175,82,39,125,0,0,336,64,0,28,0,235,186,421,428
2012,11,94,9413,PAPUA,BOVEN DIGOEL,1374,0,1129,245,0,17,16,73,52,49,32,13,20,107,109,0,0,158,81,33,216,0,24,281,179,0,28,0,259,229,488,488
2012,11,94,9404,PAPUA,NABIRE,8019,0,6622,457,0,49,39,172,171,138,126,107,135,1048,1066,0,0,431,264,242,2114,0,0,1773,1223,2,58,0,1514,1537,3051,3056
2012,11,94,9408,PAPUA,KEPULAUAN YAPEN,1698,0,1100,85,0,20,17,45,46,43,38,38,30,102,133,0,0,128,81,68,235,0,32,478,29,0,5,0,248,264,512,512
2012,11,94,9412,PAPUA,MIMIKA,15216,0,14851,345,0,120,60,507,464,397,370,356,311,2257,1790,0,0,1151,767,667,4047,0,28,3526,2410,106,383,0,3637,2995,6632,6425
2012,11,94,9410,PAPUA,PANIAI,0,0,0,0,0,0,0,0,0,0,0,0,0,0,0,0,0,0,0,0,0,0,0,0,0,0,0,0,0,0,0,0
2012,11,94,9415,PAPUA,ASMAT,1184,0,109,533,0,14,25,41,25,22,13,18,18,109,83,0,0,105,35,36,192,0,0,189,127,3,44,0,204,164,368,363
2012,11,94,9426,PAPUA,WAROPEN,730,0,730,0,0,17,10,47,47,24,25,21,16,86,161,0,0,121,49,37,247,0,0,362,46,0,2,0,195,259,454,410
2012,11,94,9402,PAPUA,JAYAWIJAYA,861,0,317,544,0,0,0,2,2,2,0,0,1,16,19,0,0,4,2,1,35,0,0,23,19,0,0,0,20,22,42,42
2012,11,94,9411,PAPUA,PUNCAK JAYA,0,0,0,0,0,0,0,0,0,0,0,0,0,0,0,0,0,0,0,0,0,0,0,0,0,0,0,0,0,0,0,0
2012,11,94,9418,PAPUA,TOLIKARA,0,0,0,0,0,0,0,0,0,0,0,0,0,0,0,0,0,0,0,0,0,0,0,0,0,0,0,0,0,0,0,0
2012,11,94,9416,PAPUA,YAHUKIMO,0,0,0,0,0,0,0,0,0,0,0,0,0,0,0,0,0,0,0,0,0,0,0,0,0,0,0,0,0,0,0,0
2012,11,94,9417,PAPUA,PEGUNUNGAN BINTANG,0,0,0,0,0,0,0,0,0,0,0,0,0,0,0,0,0,0,0,0,0,0,0,0,0,0,0,0,0,0,0,0
2012,12,91,9171,PAPUA BARAT,KOTA SORONG,2046,0,2171,0,0,12,5,40,42,33,25,33,22,97,89,0,0,99,58,55,186,0,0,120,275,0,4,0,215,183,398,399
2012,12,91,9107,PAPUA BARAT,SORONG,1541,0,1309,36,0,0,0,13,7,1,4,8,2,39,23,0,0,20,5,10,62,0,0,69,26,0,2,0,61,36,97,97
2012,12,91,9106,PAPUA BARAT,SORONG SELATAN,1522,0,1265,185,0,34,35,126,139,48,48,18,30,165,179,0,0,334,96,48,344,0,0,60,749,0,0,0,391,431,822,809
2012,12,91,9108,PAPUA BARAT,RAJA AMPAT,252,0,89,78,0,0,0,1,1,10,1,7,17,97,33,0,0,2,11,24,130,0,0,9,166,0,0,0,115,52,167,175
2012,12,91,9105,PAPUA BARAT,MANOKWARI,2527,0,1953,396,0,36,49,149,143,100,66,59,35,252,254,0,0,377,166,94,506,0,0,517,549,0,52,0,596,547,1143,1118
2012,12,91,9104,PAPUA BARAT,TELUK BINTUNI,240,0,191,68,0,1,0,2,0,2,0,1,1,11,9,0,0,3,2,2,20,0,0,23,5,0,0,0,17,10,27,28
2012,12,91,9103,PAPUA BARAT,TELUK WONDAMA,611,0,598,7,0,11,6,31,24,26,17,14,9,72,43,0,0,72,43,23,115,0,0,124,107,0,22,0,154,99,253,253
2012,12,91,9101,PAPUA BARAT,FAKFAK,3083,0,2973,190,0,17,18,125,81,96,75,97,75,255,239,0,0,241,171,172,494,0,0,776,297,1,9,0,590,488,1078,1083
2012,12,91,9102,PAPUA BARAT,KAIMANA,983,0,717,101,0,2,4,19,19,3,8,3,3,40,27,0,0,44,11,6,67,0,0,89,36,0,1,0,67,61,128,126
2012,12,94,9403,PAPUA,JAYAPURA,5421,0,3647,278,0,28,21,151,156,162,112,83,90,371,322,0,0,356,274,173,693,0,0,1019,418,3,56,0,795,701,1496,1496
2012,12,94,9471,PAPUA,KOTA JAYAPURA,4209,0,4155,39,0,8,6,87,81,68,46,53,34,221,181,0,0,182,114,87,402,0,0,474,279,6,34,0,437,348,785,793
2012,12,94,9420,PAPUA,KEEROM,6002,0,5908,94,0,24,26,156,132,142,134,91,113,673,575,0,0,338,276,204,1248,0,0,1109,822,0,137,0,1086,980,2066,2068
2012,12,94,9419,PAPUA,SARMI,689,0,563,3,0,3,5,19,17,16,17,10,8,35,31,0,0,44,33,18,66,0,0,199,46,0,5,0,83,78,161,250
2012,12,94,9409,PAPUA,BIAK NUMFOR,639,0,538,73,0,2,1,3,6,8,5,14,6,4,4,0,0,12,13,20,8,0,0,23,26,0,4,0,31,22,53,53
2012,12,94,9427,PAPUA,SUPIORI,334,0,112,52,0,3,7,17,19,6,20,3,4,41,51,0,0,46,26,7,92,0,0,109,57,0,6,0,70,101,171,172
2012,12,94,9401,PAPUA,MERAUKE,1050,0,949,101,0,32,23,118,64,80,54,13,17,151,278,0,0,237,134,30,429,0,0,2,827,0,0,0,394,436,830,829
2012,12,94,9414,PAPUA,MAPPI,1194,0,512,417,0,8,58,41,58,31,27,14,11,55,41,0,0,165,58,25,96,0,0,215,31,0,52,0,149,195,344,298
2012,12,94,9413,PAPUA,BOVEN DIGOEL,907,0,744,163,0,112,29,112,26,22,13,12,5,94,61,0,0,279,35,17,155,0,0,188,73,0,19,0,352,134,486,280
2012,12,94,9404,PAPUA,NABIRE,3253,0,2411,276,0,57,50,119,104,69,86,106,102,391,338,0,0,330,155,208,729,0,0,829,475,2,107,0,742,680,1422,1413
2012,12,94,9408,PAPUA,KEPULAUAN YAPEN,4318,0,1051,3,0,14,10,53,47,34,37,14,24,63,81,0,0,124,71,38,144,0,0,357,18,0,2,0,178,199,377,377
2012,12,94,9412,PAPUA,MIMIKA,17481,0,17156,325,0,83,87,549,533,442,399,331,328,2217,1989,0,0,1252,841,659,4206,0,0,3929,2607,101,315,0,3622,3336,6958,6952
2012,12,94,9410,PAPUA,PANIAI,0,0,0,0,0,0,0,0,0,0,0,0,0,0,0,0,0,0,0,0,0,0,0,0,0,0,0,0,0,0,0,0
2012,12,94,9415,PAPUA,ASMAT,767,0,114,420,0,6,5,18,11,4,8,3,3,24,16,0,0,40,12,6,40,0,0,45,25,1,24,0,55,43,98,95
2012,12,94,9426,PAPUA,WAROPEN,0,0,0,0,0,0,0,0,0,0,0,0,0,0,0,0,0,0,0,0,0,0,0,0,0,0,0,0,0,0,0,0
2012,12,94,9402,PAPUA,JAYAWIJAYA,484,0,51,403,0,1,1,10,8,3,1,1,4,31,25,0,0,20,4,5,56,0,0,31,49,0,3,0,46,39,85,83
2012,12,94,9411,PAPUA,PUNCAK JAYA,0,0,0,0,0,0,0,0,0,0,0,0,0,0,0,0,0,0,0,0,0,0,0,0,0,0,0,0,0,0,0,0
2012,12,94,9418,PAPUA,TOLIKARA,0,0,0,0,0,0,0,0,0,0,0,0,0,0,0,0,0,0,0,0,0,0,0,0,0,0,0,0,0,0,0,0
2012,12,94,9416,PAPUA,YAHUKIMO,0,0,0,0,0,0,0,0,0,0,0,0,0,0,0,0,0,0,0,0,0,0,0,0,0,0,0,0,0,0,0,0
2012,12,94,9417,PAPUA,PEGUNUNGAN BINTANG,0,0,0,0,0,0,0,0,0,0,0,0,0,0,0,0,0,0,0,0,0,0,0,0,0,0,0,0,0,0,0,0
2013,1,91,9171,PAPUA BARAT,KOTA SORONG,2799,0,2626,72,0,13,8,45,43,43,33,39,38,92,57,0,0,109,76,77,149,0,1,182,269,0,0,0,232,179,411,451
2013,1,91,9107,PAPUA BARAT,SORONG,2049,0,1639,139,0,3,1,11,4,9,12,7,6,63,64,0,0,19,21,13,127,0,0,106,48,0,24,0,93,87,180,178
2013,1,91,9106,PAPUA BARAT,SORONG SELATAN,1600,0,222,222,0,54,53,110,118,75,65,66,48,143,171,0,0,335,140,114,314,0,0,105,771,0,2,0,448,455,903,878
2013,1,91,9108,PAPUA BARAT,RAJA AMPAT,1247,0,121,839,0,10,17,23,40,49,49,82,41,184,214,0,0,90,98,123,398,0,0,132,541,0,42,0,348,361,709,715
2013,1,91,9105,PAPUA BARAT,MANOKWARI,3765,0,3070,56,0,65,61,174,208,144,117,89,74,291,301,0,0,508,261,163,592,0,0,479,781,0,29,0,763,761,1524,1289
2013,1,91,9104,PAPUA BARAT,TELUK BINTUNI,261,0,202,88,0,0,0,5,3,4,2,8,1,16,9,0,0,8,6,9,25,0,0,38,13,0,10,0,33,15,48,61
2013,1,91,9103,PAPUA BARAT,TELUK WONDAMA,1306,0,1186,101,0,12,9,73,39,27,19,10,16,86,64,0,0,133,46,26,150,0,12,244,77,0,35,0,208,147,355,356
2013,1,91,9101,PAPUA BARAT,FAKFAK,2634,0,2706,36,0,26,25,98,83,85,78,67,43,142,98,0,0,232,163,110,240,0,6,633,169,0,6,0,418,327,745,808
2013,1,91,9102,PAPUA BARAT,KAIMANA,1175,0,838,201,0,5,2,7,9,3,5,4,4,40,24,0,0,23,8,8,64,0,2,83,28,0,1,0,59,44,103,112
2013,1,94,9403,PAPUA,JAYAPURA,5335,0,4695,640,0,19,35,199,168,211,186,95,84,487,425,0,0,421,397,179,912,0,0,1250,595,6,94,0,1011,898,1909,1945
2013,1,94,9471,PAPUA,KOTA JAYAPURA,7266,0,6793,473,0,11,11,110,112,119,105,109,92,648,433,0,0,244,224,201,1081,0,0,946,744,5,69,0,997,753,1750,1764
2013,1,94,9420,PAPUA,KEEROM,8686,0,7955,731,0,51,33,241,245,250,240,180,172,1015,843,0,0,570,490,352,1858,0,0,1739,1349,0,183,0,1737,1533,3270,3271
2013,1,94,9419,PAPUA,SARMI,972,0,907,65,0,15,5,62,42,33,42,12,23,92,78,0,0,124,75,35,170,0,0,296,93,0,15,0,214,190,404,404
2013,1,94,9409,PAPUA,BIAK NUMFOR,2069,0,1711,29,0,5,1,8,12,15,15,11,10,28,27,0,0,26,30,21,55,0,0,46,77,0,9,0,67,65,132,132
2013,1,94,9427,PAPUA,SUPIORI,993,0,296,192,0,9,11,17,23,21,20,20,23,47,54,0,0,60,41,43,101,0,0,47,146,34,22,0,114,131,245,249
2013,1,94,9401,PAPUA,MERAUKE,1032,0,763,170,0,8,9,20,17,12,15,7,10,39,49,0,0,54,27,17,88,0,0,91,95,0,0,0,86,100,186,186
2013,1,94,9414,PAPUA,MAPPI,293,0,65,221,0,8,13,33,30,20,29,8,9,19,22,0,0,84,49,17,41,0,0,115,25,0,51,0,88,103,191,191
2013,1,94,9413,PAPUA,BOVEN DIGOEL,1328,0,1248,80,0,16,13,56,52,29,21,17,13,93,110,0,0,137,50,30,203,0,0,242,155,0,23,0,211,209,420,420
2013,1,94,9404,PAPUA,NABIRE,2978,0,2399,394,0,36,29,143,122,129,93,80,64,301,268,0,0,330,222,144,569,0,0,551,611,0,68,0,689,576,1265,1230
2013,1,94,9408,PAPUA,KEPULAUAN YAPEN,2055,0,1872,57,0,43,30,120,94,79,73,51,43,109,193,0,0,287,152,94,302,0,0,743,66,1,25,0,402,433,835,835
2013,1,94,9412,PAPUA,MIMIKA,20844,0,20003,779,0,109,102,658,616,550,507,435,348,3380,2859,0,0,1485,1057,783,6239,0,0,5415,3663,92,426,0,5132,4432,9564,9596
2013,1,94,9410,PAPUA,PANIAI,0,0,0,0,0,0,0,0,0,0,0,0,0,0,0,0,0,0,0,0,0,0,0,0,0,0,0,0,0,0,0,0
2013,1,94,9415,PAPUA,ASMAT,1420,0,537,433,0,18,17,106,84,70,51,52,39,147,156,0,0,225,121,91,303,0,0,565,126,0,108,0,393,347,740,799
2013,1,94,9426,PAPUA,WAROPEN,433,0,431,2,0,17,7,37,7,37,35,26,14,39,48,0,0,68,72,40,87,0,0,267,17,0,0,0,156,111,267,284
2013,1,94,9402,PAPUA,JAYAWIJAYA,874,0,785,87,0,3,5,18,11,7,6,5,1,54,40,0,0,37,13,6,94,0,0,69,76,0,5,0,87,63,150,150
2013,1,94,9411,PAPUA,PUNCAK JAYA,0,0,0,0,0,0,0,0,0,0,0,0,0,0,0,0,0,0,0,0,0,0,0,0,0,0,0,0,0,0,0,0
2013,1,94,9418,PAPUA,TOLIKARA,0,0,0,0,0,0,0,0,0,0,0,0,0,0,0,0,0,0,0,0,0,0,0,0,0,0,0,0,0,0,0,0
2013,1,94,9416,PAPUA,YAHUKIMO,0,0,0,0,0,0,0,0,0,0,0,0,0,0,0,0,0,0,0,0,0,0,0,0,0,0,0,0,0,0,0,0
2013,1,94,9417,PAPUA,PEGUNUNGAN BINTANG,0,0,0,0,0,0,0,0,0,0,0,0,0,0,0,0,0,0,0,0,0,0,0,0,0,0,0,0,0,0,0,0
2013,2,91,9171,PAPUA BARAT,KOTA SORONG,1924,0,1731,30,0,18,6,33,31,43,38,27,21,97,76,0,0,88,81,48,173,0,3,150,236,0,2,0,218,172,390,388
2013,2,91,9107,PAPUA BARAT,SORONG,2002,0,1475,298,0,3,0,9,14,17,16,8,6,73,38,0,0,26,33,14,111,0,0,89,66,0,29,0,110,74,184,184
2013,2,91,9106,PAPUA BARAT,SORONG SELATAN,2060,0,889,382,0,49,57,133,133,87,58,26,31,127,176,0,0,372,145,57,303,0,0,76,765,0,10,0,422,455,877,851
2013,2,91,9108,PAPUA BARAT,RAJA AMPAT,270,0,77,96,0,2,2,7,11,18,11,9,5,52,34,0,0,22,29,14,86,0,16,23,117,0,11,0,88,63,151,151
2013,2,91,9105,PAPUA BARAT,MANOKWARI,2627,0,2380,110,0,50,44,107,120,74,67,49,43,79,87,0,0,321,141,92,166,0,0,82,609,0,11,0,359,361,720,702
2013,2,91,9104,PAPUA BARAT,TELUK BINTUNI,223,0,165,72,0,0,0,4,2,2,1,1,2,10,10,0,0,6,3,3,20,0,0,21,9,0,0,0,17,15,32,30
2013,2,91,9103,PAPUA BARAT,TELUK WONDAMA,440,0,376,46,0,10,7,46,42,20,22,11,10,67,61,0,0,105,42,21,128,0,0,170,97,0,29,0,154,142,296,296
2013,2,91,9101,PAPUA BARAT,FAKFAK,2451,0,2308,33,0,14,16,67,55,48,55,103,116,168,187,0,0,152,103,219,355,0,9,679,149,0,1,0,400,429,829,829
2013,2,91,9102,PAPUA BARAT,KAIMANA,1167,0,752,158,0,0,2,6,6,7,8,5,8,6,10,0,0,14,15,13,16,0,2,65,29,0,4,0,24,34,58,98
2013,2,94,9403,PAPUA,JAYAPURA,6348,0,5423,1060,0,22,25,219,192,230,228,156,165,625,551,0,0,458,458,321,1176,0,0,1662,632,4,110,0,1252,1161,2413,2408
2013,2,94,9471,PAPUA,KOTA JAYAPURA,7904,0,7223,681,0,23,15,138,122,154,142,133,116,752,486,0,0,298,296,249,1238,0,0,1096,889,8,84,0,1200,881,2081,2077
2013,2,94,9420,PAPUA,KEEROM,4893,0,4278,615,0,17,18,151,141,154,160,127,108,515,397,0,0,327,314,235,912,0,0,975,705,0,98,0,964,824,1788,1778
2013,2,94,9419,PAPUA,SARMI,849,0,790,51,0,5,7,54,43,38,22,24,17,102,70,0,0,109,60,41,172,0,0,306,61,0,17,0,223,159,382,384
2013,2,94,9409,PAPUA,BIAK NUMFOR,1034,0,960,15,0,4,2,10,3,6,4,6,11,8,13,0,0,19,10,17,21,0,0,36,31,0,0,0,34,33,67,67
2013,2,94,9427,PAPUA,SUPIORI,406,0,246,79,0,3,3,14,12,14,9,2,4,31,33,0,0,32,23,6,64,0,0,64,63,0,1,0,64,61,125,128
2013,2,94,9401,PAPUA,MERAUKE,1070,0,727,203,0,2,3,25,26,29,20,13,7,37,36,0,0,56,49,20,73,0,0,81,117,0,0,0,106,92,198,198
2013,2,94,9414,PAPUA,MAPPI,484,0,273,134,0,5,10,33,29,30,12,13,44,40,13,0,0,77,42,57,53,0,0,111,64,0,53,0,121,108,229,228
2013,2,94,9413,PAPUA,BOVEN DIGOEL,1364,0,1180,168,0,25,15,80,69,38,46,15,23,92,132,0,0,189,84,38,224,0,0,392,133,0,28,0,250,285,535,553
2013,2,94,9404,PAPUA,NABIRE,3567,0,2935,286,0,29,29,108,102,95,97,104,67,299,437,0,0,268,192,171,736,0,0,570,587,3,108,0,635,732,1367,1268
2013,2,94,9408,PAPUA,KEPULAUAN YAPEN,1738,0,1704,0,0,22,20,80,81,55,56,30,44,98,199,0,0,203,111,74,297,0,0,588,81,81,16,0,285,400,685,766
2013,2,94,9412,PAPUA,MIMIKA,20643,0,20038,789,0,111,83,649,626,531,525,391,316,2895,2425,0,0,1469,1056,707,5320,0,0,4667,3376,3,445,0,4577,3975,8552,8491
2013,2,94,9410,PAPUA,PANIAI,603,0,112,491,0,20,15,25,22,24,33,40,49,90,85,0,0,82,57,89,175,0,0,224,196,0,0,0,199,204,403,420
2013,2,94,9415,PAPUA,ASMAT,1240,0,629,377,0,31,28,108,99,77,68,41,19,158,142,0,0,266,145,60,300,0,0,359,243,0,106,0,415,356,771,708
2013,2,94,9426,PAPUA,WAROPEN,663,0,663,0,0,14,10,47,54,30,36,34,33,114,110,0,0,125,66,67,224,0,0,446,33,0,0,0,239,243,482,479
2013,2,94,9402,PAPUA,JAYAWIJAYA,1331,0,1190,141,0,1,2,12,7,6,6,8,3,49,38,0,0,22,12,11,87,0,0,72,58,0,1,0,76,56,132,131
2013,2,94,9411,PAPUA,PUNCAK JAYA,0,0,0,0,0,0,0,0,0,0,0,0,0,0,0,0,0,0,0,0,0,0,0,0,0,0,0,0,0,0,0,0
2013,2,94,9418,PAPUA,TOLIKARA,0,0,0,0,0,0,0,0,0,0,0,0,0,0,0,0,0,0,0,0,0,0,0,0,0,0,0,0,0,0,0,0
2013,2,94,9416,PAPUA,YAHUKIMO,0,0,0,0,0,0,0,0,0,0,0,0,0,0,0,0,0,0,0,0,0,0,0,0,0,0,0,0,0,0,0,0
2013,2,94,9417,PAPUA,PEGUNUNGAN BINTANG,0,0,0,0,0,0,0,0,0,0,0,0,0,0,0,0,0,0,0,0,0,0,0,0,0,0,0,0,0,0,0,0
2013,3,91,9171,PAPUA BARAT,KOTA SORONG,2665,0,2424,57,0,8,11,45,32,36,29,36,23,107,72,0,0,96,65,59,179,0,0,146,234,0,8,0,232,167,399,388
2013,3,91,9107,PAPUA BARAT,SORONG,1943,0,1176,528,0,3,0,10,7,13,12,10,3,87,31,0,0,20,25,13,118,0,1,91,56,0,24,0,123,53,176,171
2013,3,91,9106,PAPUA BARAT,SORONG SELATAN,2230,0,2066,198,0,32,30,89,95,60,45,60,35,126,117,0,0,246,105,95,243,0,0,47,585,0,0,0,367,322,689,632
2013,3,91,9108,PAPUA BARAT,RAJA AMPAT,340,0,89,132,0,6,5,21,28,14,19,21,13,57,26,0,0,60,33,34,83,0,1,24,154,0,10,0,119,91,210,188
2013,3,91,9105,PAPUA BARAT,MANOKWARI,4738,0,4145,435,0,150,151,358,334,211,180,211,154,577,494,0,0,993,391,365,1071,0,67,1050,1731,0,84,0,1507,1313,2820,2865
2013,3,91,9104,PAPUA BARAT,TELUK BINTUNI,280,0,161,129,0,0,1,3,1,2,2,2,0,24,4,0,0,5,4,2,28,0,0,25,9,0,12,0,31,8,39,46
2013,3,91,9103,PAPUA BARAT,TELUK WONDAMA,4031,0,2488,465,0,42,19,141,123,69,64,72,29,152,129,0,0,325,133,101,281,0,40,352,295,2,23,0,476,364,840,672
2013,3,91,9101,PAPUA BARAT,FAKFAK,2346,0,2310,67,0,28,23,99,96,63,53,63,20,82,90,0,0,246,116,83,172,0,13,486,84,0,2,0,335,282,617,572
2013,3,91,9102,PAPUA BARAT,KAIMANA,833,0,586,124,0,0,3,11,8,13,7,13,9,24,19,0,0,22,20,22,43,0,1,56,31,0,12,0,61,46,107,99
2013,3,94,9403,PAPUA,JAYAPURA,8304,0,5956,2275,0,40,61,338,286,375,306,204,214,1030,774,0,0,725,681,418,1804,0,0,2304,925,1,398,0,1987,1641,3628,3628
2013,3,94,9471,PAPUA,KOTA JAYAPURA,7946,0,7228,648,0,18,12,170,134,142,135,148,122,950,537,0,0,334,277,270,1487,0,16,1334,882,8,145,0,1428,940,2368,2369
2013,3,94,9420,PAPUA,KEEROM,3038,0,2221,817,0,10,10,79,117,143,121,74,70,424,285,0,0,216,264,144,709,0,2,735,479,0,159,0,730,603,1333,1373
2013,3,94,9419,PAPUA,SARMI,668,0,547,93,0,10,4,38,30,32,30,12,13,88,83,0,0,82,62,25,171,0,2,263,66,0,11,0,180,160,340,340
2013,3,94,9409,PAPUA,BIAK NUMFOR,1273,0,1015,255,0,10,18,39,44,47,31,26,26,87,113,0,0,111,78,52,200,0,89,108,297,0,36,0,209,232,441,441
2013,3,94,9427,PAPUA,SUPIORI,562,0,220,337,0,49,7,17,9,7,4,5,3,33,20,0,0,82,11,8,53,0,8,54,65,0,1,0,111,43,154,120
2013,3,94,9401,PAPUA,MERAUKE,994,0,874,91,0,10,15,52,52,44,35,19,17,89,83,0,0,129,79,36,172,0,1,167,249,0,0,0,214,202,416,416
2013,3,94,9414,PAPUA,MAPPI,384,0,142,170,0,8,5,23,14,6,11,9,6,26,30,0,0,50,17,15,56,0,2,89,33,0,16,0,72,66,138,138
2013,3,94,9413,PAPUA,BOVEN DIGOEL,1438,0,1153,285,0,10,15,53,49,30,26,15,20,80,67,0,0,127,56,35,147,0,4,254,94,0,16,0,188,177,365,364
2013,3,94,9404,PAPUA,NABIRE,5043,0,3228,486,0,18,15,72,58,75,91,100,126,625,618,0,0,163,166,226,1243,0,23,704,944,0,79,0,890,908,1798,1727
2013,3,94,9408,PAPUA,KEPULAUAN YAPEN,353,0,264,9,0,7,4,19,23,15,16,10,10,20,44,0,0,53,31,20,64,0,0,154,12,0,2,0,71,97,168,168
2013,3,94,9412,PAPUA,MIMIKA,13530,0,11951,1567,0,66,76,436,403,339,301,263,250,2066,1840,0,0,981,640,513,3906,0,3,2745,2729,43,509,0,3170,2870,6040,6026
2013,3,94,9410,PAPUA,PANIAI,554,0,104,450,0,33,29,16,26,38,38,13,34,75,68,0,0,104,76,47,143,0,0,179,209,0,0,0,175,195,370,388
2013,3,94,9415,PAPUA,ASMAT,1134,0,464,475,0,35,40,110,107,79,58,48,41,154,133,0,0,292,137,89,287,0,11,448,144,0,215,0,426,379,805,807
2013,3,94,9426,PAPUA,WAROPEN,488,0,488,0,0,8,6,26,37,19,20,27,11,91,102,0,0,77,39,38,193,0,0,310,39,0,0,0,171,176,347,349
2013,3,94,9402,PAPUA,JAYAWIJAYA,1905,0,1721,184,0,6,5,23,18,14,6,7,12,98,72,0,0,52,20,19,170,0,19,103,132,7,16,0,148,113,261,258
2013,3,94,9411,PAPUA,PUNCAK JAYA,0,0,0,0,0,0,0,0,0,0,0,0,0,0,0,0,0,0,0,0,0,0,0,0,0,0,0,0,0,0,0,0
2013,3,94,9418,PAPUA,TOLIKARA,0,0,0,0,0,0,0,0,0,0,0,0,0,0,0,0,0,0,0,0,0,0,0,0,0,0,0,0,0,0,0,0
2013,3,94,9416,PAPUA,YAHUKIMO,0,0,0,0,0,0,0,0,0,0,0,0,0,0,0,0,0,0,0,0,0,0,0,0,0,0,0,0,0,0,0,0
2013,3,94,9417,PAPUA,PEGUNUNGAN BINTANG,0,0,0,0,0,0,0,0,0,0,0,0,0,0,0,0,0,0,0,0,0,0,0,0,0,0,0,0,0,0,0,0
2013,4,91,9171,PAPUA BARAT,KOTA SORONG,545,0,558,18,0,0,2,19,19,28,14,22,13,48,34,0,0,40,42,35,82,0,0,114,76,0,4,0,117,82,199,194
2013,4,91,9107,PAPUA BARAT,SORONG,1370,0,814,413,0,2,1,13,11,22,31,25,19,71,65,0,0,27,53,44,136,0,0,119,63,0,78,0,133,127,260,260
2013,4,91,9106,PAPUA BARAT,SORONG SELATAN,2862,0,1398,125,0,60,62,141,128,88,101,53,37,181,215,0,0,391,189,90,396,0,0,43,869,0,0,0,523,543,1066,912
2013,4,91,9108,PAPUA BARAT,RAJA AMPAT,393,0,289,84,0,0,0,0,0,0,0,12,5,46,33,0,0,0,0,17,79,0,0,96,0,0,0,0,58,38,96,96
2013,4,91,9105,PAPUA BARAT,MANOKWARI,2913,0,2276,510,0,48,41,172,182,103,86,66,53,218,314,0,0,443,189,119,532,0,0,543,752,0,34,0,607,676,1283,1329
2013,4,91,9104,PAPUA BARAT,TELUK BINTUNI,172,0,165,24,0,0,0,2,3,1,0,1,0,13,9,0,0,5,1,1,22,0,0,22,4,0,3,0,17,12,29,29
2013,4,91,9103,PAPUA BARAT,TELUK WONDAMA,2581,0,2581,450,0,21,20,102,83,78,72,70,54,111,91,0,0,226,150,124,202,0,0,257,94,0,14,0,382,320,702,365
2013,4,91,9101,PAPUA BARAT,FAKFAK,1795,0,1792,3,0,20,34,142,129,128,147,136,113,313,194,0,0,325,275,249,507,0,0,539,135,0,1,0,739,617,1356,675
2013,4,91,9102,PAPUA BARAT,KAIMANA,706,0,514,89,0,1,1,8,7,6,6,3,3,31,11,0,0,17,12,6,42,0,0,49,26,0,2,0,49,28,77,77
2013,4,94,9403,PAPUA,JAYAPURA,9739,0,8458,1253,0,37,46,345,316,468,367,321,306,1100,1039,0,0,744,835,627,2139,0,0,3093,1063,2,189,0,2271,2074,4345,4347
2013,4,94,9471,PAPUA,KOTA JAYAPURA,6959,0,6505,454,0,38,14,135,124,187,140,148,129,880,587,0,0,311,327,277,1467,0,18,1395,815,4,148,0,1388,994,2382,2362
2013,4,94,9420,PAPUA,KEEROM,6291,0,5547,744,0,29,23,206,174,205,155,150,111,900,734,0,0,432,360,261,1634,0,17,1647,849,3,189,0,1490,1197,2687,2688
2013,4,94,9419,PAPUA,SARMI,734,0,689,45,0,8,10,36,38,38,29,23,20,93,100,0,0,92,67,43,193,0,1,311,76,0,7,0,198,197,395,394
2013,4,94,9409,PAPUA,BIAK NUMFOR,1439,0,1190,249,0,1,2,22,15,12,20,12,11,32,61,0,0,40,32,23,93,0,19,55,137,0,8,0,79,109,188,200
2013,4,94,9427,PAPUA,SUPIORI,324,0,255,69,0,1,9,16,5,5,6,1,1,92,35,0,0,31,11,2,127,0,0,75,49,0,0,0,115,56,171,124
2013,4,94,9401,PAPUA,MERAUKE,1279,0,1167,112,0,20,19,59,54,43,44,21,21,23,92,0,0,152,87,42,115,0,18,41,424,0,0,0,166,230,396,465
2013,4,94,9414,PAPUA,MAPPI,416,0,273,143,0,6,13,40,43,22,16,15,7,131,39,0,0,102,38,22,170,0,20,122,95,0,9,0,214,118,332,226
2013,4,94,9413,PAPUA,BOVEN DIGOEL,1528,0,1217,311,0,11,10,71,68,36,41,28,47,645,108,0,0,160,77,75,753,0,4,336,135,0,73,0,791,274,1065,544
2013,4,94,9404,PAPUA,NABIRE,4185,0,3341,833,0,38,38,92,72,123,92,137,126,91,589,0,0,240,215,263,680,0,23,932,1067,0,96,0,481,917,1398,2095
2013,4,94,9408,PAPUA,KEPULAUAN YAPEN,2124,0,1847,131,0,62,44,69,77,66,67,63,60,131,167,0,0,252,133,123,298,0,39,684,52,0,26,0,391,415,806,762
2013,4,94,9412,PAPUA,MIMIKA,22972,0,19366,3499,0,332,265,1182,833,742,616,569,1657,1597,5793,0,0,2612,1358,2226,7390,0,107,6333,4391,145,2713,0,4422,9164,13586,13582
2013,4,94,9410,PAPUA,PANIAI,688,0,109,579,0,17,15,26,28,31,42,66,69,152,116,0,0,86,73,135,268,0,0,301,260,0,29,0,292,270,562,590
2013,4,94,9415,PAPUA,ASMAT,1336,0,298,1038,0,25,27,104,121,84,70,60,47,24,165,0,0,277,154,107,189,0,85,451,265,0,207,0,297,430,727,923
2013,4,94,9426,PAPUA,WAROPEN,281,0,281,0,0,6,2,13,11,12,15,12,10,80,41,0,0,32,27,22,121,0,0,124,32,0,0,0,123,79,202,156
2013,4,94,9402,PAPUA,JAYAWIJAYA,1769,0,1599,170,0,2,4,16,9,9,11,3,6,90,66,0,0,31,20,9,156,0,27,94,103,2,17,0,120,96,216,216
2013,4,94,9411,PAPUA,PUNCAK JAYA,0,0,0,0,0,0,0,0,0,0,0,0,0,0,0,0,0,0,0,0,0,0,0,0,0,0,0,0,0,0,0,0
2013,4,94,9418,PAPUA,TOLIKARA,0,0,0,0,0,0,0,0,0,0,0,0,0,0,0,0,0,0,0,0,0,0,0,0,0,0,0,0,0,0,0,0
2013,4,94,9416,PAPUA,YAHUKIMO,0,0,0,0,0,0,0,0,0,0,0,0,0,0,0,0,0,0,0,0,0,0,0,0,0,0,0,0,0,0,0,0
2013,4,94,9417,PAPUA,PEGUNUNGAN BINTANG,0,0,0,0,0,0,0,0,0,0,0,0,0,0,0,0,0,0,0,0,0,0,0,0,0,0,0,0,0,0,0,0
2013,5,91,9171,PAPUA BARAT,KOTA SORONG,2541,0,2482,31,0,13,8,53,51,43,41,37,23,92,69,0,0,125,84,60,161,0,0,137,299,0,3,0,238,192,430,439
2013,5,91,9107,PAPUA BARAT,SORONG,1740,0,1412,153,0,0,0,8,11,11,6,5,3,44,26,0,0,19,17,8,70,0,0,84,19,0,3,0,68,46,114,106
2013,5,91,9106,PAPUA BARAT,SORONG SELATAN,1546,0,1441,105,0,56,48,93,98,51,63,28,28,174,152,0,0,295,114,56,326,0,0,74,670,0,0,0,402,389,791,744
2013,5,91,9108,PAPUA BARAT,RAJA AMPAT,0,0,0,0,0,0,0,0,0,0,0,0,0,0,0,0,0,0,0,0,0,0,0,0,0,0,0,0,0,0,0,0
2013,5,91,9105,PAPUA BARAT,MANOKWARI,1815,0,1289,213,0,31,38,93,99,63,56,53,37,154,155,0,0,261,119,90,309,0,0,267,473,0,28,0,394,385,779,768
2013,5,91,9104,PAPUA BARAT,TELUK BINTUNI,195,0,125,70,0,0,0,3,1,2,1,2,1,9,3,0,0,4,3,3,12,0,0,15,3,0,0,0,16,6,22,18
2013,5,91,9103,PAPUA BARAT,TELUK WONDAMA,0,0,0,0,0,0,0,0,0,0,0,0,0,0,0,0,0,0,0,0,0,0,0,0,0,0,0,0,0,0,0,0
2013,5,91,9101,PAPUA BARAT,FAKFAK,1407,0,1407,11,0,10,11,61,60,43,36,22,17,71,86,0,0,142,79,39,157,0,3,369,65,0,0,0,207,210,417,434
2013,5,91,9102,PAPUA BARAT,KAIMANA,615,0,511,269,0,3,2,12,8,11,6,8,2,20,12,0,0,25,17,10,32,0,0,53,23,0,8,0,54,30,84,84
2013,5,94,9403,PAPUA,JAYAPURA,8033,0,7280,753,0,28,44,265,265,335,290,233,234,879,827,0,0,602,625,467,1706,0,0,2464,812,0,124,0,1740,1660,3400,3400
2013,5,94,9471,PAPUA,KOTA JAYAPURA,6836,0,6319,517,0,17,23,144,114,151,136,111,119,690,416,0,0,298,287,230,1106,0,22,1125,717,11,65,0,1113,808,1921,1918
2013,5,94,9420,PAPUA,KEEROM,5489,0,4293,1196,0,23,18,230,210,194,170,143,134,811,547,0,0,481,364,277,1358,0,20,1532,804,0,144,0,1401,1079,2480,2480
2013,5,94,9419,PAPUA,SARMI,833,0,755,22,0,10,7,49,38,33,27,16,7,100,104,0,0,104,60,23,204,0,2,302,77,0,3,0,208,183,391,382
2013,5,94,9409,PAPUA,BIAK NUMFOR,1129,0,943,173,0,8,4,29,29,26,25,22,15,87,122,0,0,70,51,37,209,0,11,42,317,0,9,0,172,195,367,368
2013,5,94,9427,PAPUA,SUPIORI,441,0,215,56,0,2,1,7,11,2,2,4,4,17,25,0,0,21,4,8,42,0,1,36,39,0,1,0,32,43,75,76
2013,5,94,9401,PAPUA,MERAUKE,926,0,785,128,0,8,6,18,20,35,30,12,15,63,75,0,0,52,65,27,138,0,0,62,220,0,0,0,136,146,282,282
2013,5,94,9414,PAPUA,MAPPI,176,0,137,39,0,2,4,13,4,4,4,5,1,9,1,0,0,23,8,6,10,0,0,35,7,0,5,0,33,14,47,47
2013,5,94,9413,PAPUA,BOVEN DIGOEL,881,0,593,288,0,7,7,41,30,31,27,24,28,110,92,0,0,85,58,52,202,0,0,195,123,0,64,0,213,184,397,382
2013,5,94,9404,PAPUA,NABIRE,4482,0,2829,735,0,36,30,90,87,94,102,109,115,627,645,0,0,243,196,224,1272,0,20,880,967,0,96,0,956,979,1935,1943
2013,5,94,9408,PAPUA,KEPULAUAN YAPEN,1477,0,1543,551,0,34,38,74,71,69,73,53,47,107,154,0,0,217,142,100,261,0,46,661,50,0,9,0,337,383,720,720
2013,5,94,9412,PAPUA,MIMIKA,15784,0,14624,1005,0,75,73,342,422,421,370,301,269,3288,2213,0,0,912,791,570,5501,0,38,4112,3227,55,371,0,4427,3347,7774,7765
2013,5,94,9410,PAPUA,PANIAI,915,0,231,684,0,26,29,35,45,69,76,45,41,140,94,0,0,135,145,86,234,0,0,343,167,0,12,0,315,285,600,522
2013,5,94,9415,PAPUA,ASMAT,866,0,0,738,0,61,62,49,56,51,52,52,37,187,147,0,0,228,103,89,334,0,26,616,408,0,418,0,400,354,754,1442
2013,5,94,9426,PAPUA,WAROPEN,380,0,285,0,0,4,2,13,4,13,24,16,13,36,65,0,0,23,37,29,101,0,0,131,59,0,0,0,82,108,190,190
2013,5,94,9402,PAPUA,JAYAWIJAYA,1683,0,1534,147,0,4,2,9,12,4,5,5,4,99,70,0,0,27,9,9,169,0,0,98,73,1,15,0,121,93,214,187
2013,5,94,9411,PAPUA,PUNCAK JAYA,0,0,0,0,0,0,0,0,0,0,0,0,0,0,0,0,0,0,0,0,0,0,0,0,0,0,0,0,0,0,0,0
2013,5,94,9418,PAPUA,TOLIKARA,0,0,0,0,0,0,0,0,0,0,0,0,0,0,0,0,0,0,0,0,0,0,0,0,0,0,0,0,0,0,0,0
2013,5,94,9416,PAPUA,YAHUKIMO,0,0,0,0,0,0,0,0,0,0,0,0,0,0,0,0,0,0,0,0,0,0,0,0,0,0,0,0,0,0,0,0
2013,5,94,9417,PAPUA,PEGUNUNGAN BINTANG,0,0,0,0,0,0,0,0,0,0,0,0,0,0,0,0,0,0,0,0,0,0,0,0,0,0,0,0,0,0,0,0
2013,6,91,9171,PAPUA BARAT,KOTA SORONG,1809,0,1803,6,0,15,8,49,43,33,27,23,16,102,0,0,0,115,60,39,102,0,0,121,300,0,7,0,222,94,316,428
2013,6,91,9107,PAPUA BARAT,SORONG,1027,0,906,67,0,1,1,4,3,7,8,3,4,43,0,0,0,9,15,7,43,0,0,61,32,0,5,0,58,16,74,98
2013,6,91,9106,PAPUA BARAT,SORONG SELATAN,0,0,0,0,0,0,0,0,0,0,0,0,0,0,0,0,0,0,0,0,0,0,0,0,0,0,0,0,0,0,0,0
2013,6,91,9108,PAPUA BARAT,RAJA AMPAT,0,0,0,0,0,0,0,0,0,0,0,0,0,0,0,0,0,0,0,0,0,0,0,0,0,0,0,0,0,0,0,0
2013,6,91,9105,PAPUA BARAT,MANOKWARI,0,0,0,0,0,0,0,0,0,0,0,0,0,0,0,0,0,0,0,0,0,0,0,0,0,0,0,0,0,0,0,0
2013,6,91,9104,PAPUA BARAT,TELUK BINTUNI,232,0,114,118,0,0,0,0,4,6,2,9,3,0,21,0,0,4,8,12,21,0,0,28,16,0,6,0,15,30,45,50
2013,6,91,9103,PAPUA BARAT,TELUK WONDAMA,0,0,0,0,0,0,0,0,0,0,0,0,0,0,0,0,0,0,0,0,0,0,0,0,0,0,0,0,0,0,0,0
2013,6,91,9101,PAPUA BARAT,FAKFAK,2279,0,2263,25,0,29,64,77,80,75,48,29,109,118,191,0,0,250,123,138,309,0,0,499,196,0,1,0,328,492,820,696
2013,6,91,9102,PAPUA BARAT,KAIMANA,418,0,321,45,0,1,2,3,4,7,2,1,1,7,5,0,0,10,9,2,12,0,0,15,17,0,1,0,19,14,33,33
2013,6,94,9403,PAPUA,JAYAPURA,5935,0,5149,786,0,24,37,242,234,279,223,126,157,563,527,0,0,537,502,283,1090,0,0,1664,640,10,98,0,1234,1178,2412,2412
2013,6,94,9471,PAPUA,KOTA JAYAPURA,6037,0,5886,151,0,9,8,127,91,112,83,85,72,532,367,0,0,235,195,157,899,0,10,952,454,5,48,0,865,621,1486,1459
2013,6,94,9420,PAPUA,KEEROM,5396,0,4459,937,0,21,20,198,206,191,137,139,116,713,502,0,0,445,328,255,1215,0,10,1409,717,0,117,0,1262,981,2243,2243
2013,6,94,9419,PAPUA,SARMI,638,0,506,60,0,4,3,31,27,18,19,3,5,38,28,0,0,65,37,8,66,0,0,133,32,0,7,0,94,82,176,172
2013,6,94,9409,PAPUA,BIAK NUMFOR,1407,0,991,416,0,5,4,17,33,24,18,19,24,58,77,0,0,59,42,43,135,0,14,69,199,0,11,0,123,156,279,279
2013,6,94,9427,PAPUA,SUPIORI,287,0,176,55,0,3,2,17,7,6,4,1,3,48,49,0,0,29,10,4,97,0,0,93,43,0,3,0,75,65,140,139
2013,6,94,9401,PAPUA,MERAUKE,1279,0,1145,112,0,15,12,37,66,35,49,32,27,109,93,0,0,130,84,59,202,0,0,85,408,0,1,0,228,247,475,494
2013,6,94,9414,PAPUA,MAPPI,0,0,0,0,0,0,0,0,0,0,0,0,0,0,0,0,0,0,0,0,0,0,0,0,0,0,0,0,0,0,0,0
2013,6,94,9413,PAPUA,BOVEN DIGOEL,1450,0,1146,304,0,9,7,69,75,37,39,21,19,138,123,0,0,160,76,40,261,0,1,345,172,0,20,0,274,263,537,537
2013,6,94,9404,PAPUA,NABIRE,3772,0,1970,1036,0,39,39,115,86,103,88,105,87,379,421,0,0,279,191,192,800,0,36,681,706,0,73,0,741,721,1462,1460
2013,6,94,9408,PAPUA,KEPULAUAN YAPEN,1910,0,1298,61,0,31,21,73,48,50,50,23,29,72,129,0,0,173,100,52,201,0,49,463,42,0,20,0,249,277,526,525
2013,6,94,9412,PAPUA,MIMIKA,15593,0,14289,1230,0,71,82,453,401,399,359,346,293,3672,2364,0,0,1007,758,639,6036,0,58,4385,3386,266,389,0,4941,3499,8440,8426
2013,6,94,9410,PAPUA,PANIAI,719,0,124,595,0,17,15,28,27,27,47,66,66,103,126,0,0,87,74,132,229,0,0,273,206,0,29,0,241,281,522,508
2013,6,94,9415,PAPUA,ASMAT,934,0,736,90,0,1,10,39,34,32,26,38,53,72,52,0,0,84,58,91,124,0,2,206,206,0,75,0,182,175,357,487
2013,6,94,9426,PAPUA,WAROPEN,266,0,201,0,0,6,4,10,16,8,6,3,2,29,53,0,0,36,14,5,82,0,0,126,7,0,0,0,56,81,137,133
2013,6,94,9402,PAPUA,JAYAWIJAYA,1390,0,1206,114,0,1,4,10,9,6,7,2,6,61,48,0,0,24,13,8,109,0,2,88,91,1,2,0,80,74,154,182
2013,6,94,9411,PAPUA,PUNCAK JAYA,0,0,0,0,0,0,0,0,0,0,0,0,0,0,0,0,0,0,0,0,0,0,0,0,0,0,0,0,0,0,0,0
2013,6,94,9418,PAPUA,TOLIKARA,0,0,0,0,0,0,0,0,0,0,0,0,0,0,0,0,0,0,0,0,0,0,0,0,0,0,0,0,0,0,0,0
2013,6,94,9416,PAPUA,YAHUKIMO,0,0,0,0,0,0,0,0,0,0,0,0,0,0,0,0,0,0,0,0,0,0,0,0,0,0,0,0,0,0,0,0
2013,6,94,9417,PAPUA,PEGUNUNGAN BINTANG,0,0,0,0,0,0,0,0,0,0,0,0,0,0,0,0,0,0,0,0,0,0,0,0,0,0,0,0,0,0,0,0
2013,7,91,9171,PAPUA BARAT,KOTA SORONG,3699,0,3446,16,0,20,9,28,34,25,33,36,29,86,127,0,0,91,58,65,213,0,0,161,264,12,0,0,195,232,427,437
2013,7,91,9107,PAPUA BARAT,SORONG,1404,0,998,93,0,0,0,6,2,7,7,6,1,31,18,0,0,8,14,7,49,0,0,97,33,0,7,0,50,28,78,137
2013,7,91,9106,PAPUA BARAT,SORONG SELATAN,1200,0,996,211,0,20,29,47,53,41,41,25,25,133,159,0,0,149,82,50,292,0,0,31,528,0,12,0,266,307,573,571
2013,7,91,9108,PAPUA BARAT,RAJA AMPAT,171,0,66,60,0,0,0,10,10,12,12,10,12,23,23,0,0,20,24,22,46,0,0,18,88,0,6,0,55,57,112,112
2013,7,91,9105,PAPUA BARAT,MANOKWARI,2611,0,1991,146,0,47,55,124,149,90,94,78,76,215,283,0,0,375,184,154,498,0,0,529,785,0,37,0,554,657,1211,1351
2013,7,91,9104,PAPUA BARAT,TELUK BINTUNI,198,0,153,45,0,0,0,3,2,4,3,2,1,9,8,0,0,5,7,3,17,0,0,19,8,0,5,0,18,14,32,32
2013,7,91,9103,PAPUA BARAT,TELUK WONDAMA,791,0,791,0,0,26,24,39,37,13,32,37,20,43,47,0,0,126,45,57,90,0,0,131,110,0,7,0,158,160,318,248
2013,7,91,9101,PAPUA BARAT,FAKFAK,1034,0,986,38,0,12,11,38,50,27,21,17,11,93,87,0,0,111,48,28,180,0,0,273,91,0,2,0,187,180,367,366
2013,7,91,9102,PAPUA BARAT,KAIMANA,671,0,525,37,0,0,2,4,3,3,5,2,4,6,11,0,0,9,8,6,17,0,0,28,11,0,2,0,15,25,40,41
2013,7,94,9403,PAPUA,JAYAPURA,5502,0,4660,818,0,25,25,188,198,227,173,156,124,580,524,0,0,436,400,280,1104,0,0,1467,674,4,76,0,1176,1044,2220,2221
2013,7,94,9471,PAPUA,KOTA JAYAPURA,5929,0,5679,250,0,19,14,85,84,111,88,68,87,503,307,0,0,202,199,155,810,0,0,754,571,1,41,0,786,580,1366,1367
2013,7,94,9420,PAPUA,KEEROM,4338,0,3595,743,0,21,16,175,144,173,146,112,88,500,465,0,0,356,319,200,965,0,0,1078,684,0,88,0,981,859,1840,1850
2013,7,94,9419,PAPUA,SARMI,960,0,749,165,0,9,2,35,23,25,19,13,8,79,53,0,0,69,44,21,132,0,0,183,78,0,5,0,161,105,266,266
2013,7,94,9409,PAPUA,BIAK NUMFOR,1807,0,1766,41,0,5,3,27,24,25,18,9,10,77,99,0,0,59,43,19,176,0,0,68,228,0,1,0,143,154,297,297
2013,7,94,9427,PAPUA,SUPIORI,345,0,133,53,0,0,4,7,8,7,0,3,6,24,20,0,0,19,7,9,44,0,0,50,50,0,6,0,41,38,79,106
2013,7,94,9401,PAPUA,MERAUKE,957,0,870,78,0,10,13,63,49,39,31,18,38,70,80,0,0,135,70,56,150,0,0,124,287,0,0,0,200,211,411,411
2013,7,94,9414,PAPUA,MAPPI,680,0,252,11,0,6,3,23,20,17,20,4,5,32,54,0,0,52,37,9,86,0,0,106,75,0,7,0,82,102,184,188
2013,7,94,9413,PAPUA,BOVEN DIGOEL,809,0,500,309,0,7,11,36,44,20,20,10,19,44,56,0,0,98,40,29,100,0,0,169,70,0,28,0,117,150,267,267
2013,7,94,9404,PAPUA,NABIRE,3694,0,1865,1025,0,6,6,22,27,54,52,89,123,641,630,0,0,61,106,212,1271,0,0,713,853,0,23,0,812,838,1650,1589
2013,7,94,9408,PAPUA,KEPULAUAN YAPEN,2836,0,2075,552,0,76,58,91,102,105,74,70,59,347,289,0,0,327,179,129,636,0,0,1186,70,0,15,0,689,582,1271,1271
2013,7,94,9412,PAPUA,MIMIKA,14930,0,14029,484,0,67,69,479,438,368,338,267,272,1918,1737,0,0,1053,706,539,3655,0,0,3096,2439,126,370,0,3099,2854,5953,6031
2013,7,94,9410,PAPUA,PANIAI,709,0,129,580,0,19,18,20,36,46,104,69,109,125,94,0,0,93,150,178,219,0,0,315,250,0,36,0,279,361,640,601
2013,7,94,9415,PAPUA,ASMAT,616,0,501,106,0,3,8,19,25,32,19,21,4,66,43,0,0,55,51,25,109,0,0,124,73,0,50,0,141,99,240,247
2013,7,94,9426,PAPUA,WAROPEN,738,0,512,0,0,13,8,22,25,18,26,17,22,78,110,0,0,68,44,39,188,0,0,243,43,0,0,0,148,191,339,286
2013,7,94,9402,PAPUA,JAYAWIJAYA,1306,0,1138,105,0,0,2,13,9,0,2,2,1,72,36,0,0,24,2,3,108,0,0,57,50,0,2,0,87,50,137,109
2013,7,94,9411,PAPUA,PUNCAK JAYA,0,0,0,0,0,0,0,0,0,0,0,0,0,0,0,0,0,0,0,0,0,0,0,0,0,0,0,0,0,0,0,0
2013,7,94,9418,PAPUA,TOLIKARA,0,0,0,0,0,0,0,0,0,0,0,0,0,0,0,0,0,0,0,0,0,0,0,0,0,0,0,0,0,0,0,0
2013,7,94,9416,PAPUA,YAHUKIMO,0,0,0,0,0,0,0,0,0,0,0,0,0,0,0,0,0,0,0,0,0,0,0,0,0,0,0,0,0,0,0,0
2013,7,94,9417,PAPUA,PEGUNUNGAN BINTANG,0,0,0,0,0,0,0,0,0,0,0,0,0,0,0,0,0,0,0,0,0,0,0,0,0,0,0,0,0,0,0,0
2013,8,91,9171,PAPUA BARAT,KOTA SORONG,2626,0,2403,0,0,10,17,30,24,40,29,38,27,104,75,0,0,81,69,65,179,0,0,129,262,0,3,0,222,172,394,394
2013,8,91,9107,PAPUA BARAT,SORONG,1589,0,1219,16,0,3,0,10,10,10,5,7,6,47,29,0,0,23,15,13,76,0,0,85,35,0,6,0,77,50,127,126
2013,8,91,9106,PAPUA BARAT,SORONG SELATAN,1402,0,1321,122,0,34,27,63,51,57,44,22,39,205,260,0,0,175,101,61,465,0,0,21,535,0,2,0,381,421,802,558
2013,8,91,9108,PAPUA BARAT,RAJA AMPAT,255,0,116,71,0,1,0,11,10,12,14,11,12,18,21,0,0,22,26,23,39,0,0,44,57,0,9,0,53,57,110,110
2013,8,91,9105,PAPUA BARAT,MANOKWARI,2217,0,1856,18,0,24,26,90,88,54,63,33,32,160,215,0,0,228,117,65,375,0,0,317,454,0,14,0,361,424,785,785
2013,8,91,9104,PAPUA BARAT,TELUK BINTUNI,218,0,179,39,0,0,0,1,2,0,1,0,3,6,4,0,0,3,1,3,10,0,0,7,8,0,2,0,7,10,17,17
2013,8,91,9103,PAPUA BARAT,TELUK WONDAMA,889,0,792,6,0,11,13,48,39,25,22,15,15,43,35,0,0,111,47,30,78,0,0,174,107,0,12,0,142,124,266,293
2013,8,91,9101,PAPUA BARAT,FAKFAK,879,0,864,15,0,14,15,51,51,35,36,16,12,59,87,0,0,131,71,28,146,0,0,317,56,0,3,0,175,201,376,376
2013,8,91,9102,PAPUA BARAT,KAIMANA,633,0,518,58,0,1,0,3,4,2,2,4,0,6,7,0,0,8,4,4,13,0,0,21,4,0,4,0,16,13,29,29
2013,8,94,9403,PAPUA,JAYAPURA,5049,0,4506,413,0,14,34,171,161,150,156,118,103,500,395,0,0,380,306,221,895,0,0,1050,612,25,115,0,953,849,1802,1802
2013,8,94,9471,PAPUA,KOTA JAYAPURA,5042,0,4756,286,0,18,5,54,51,63,68,72,86,458,347,0,0,128,131,158,805,0,0,716,572,1,44,0,665,557,1222,1333
2013,8,94,9420,PAPUA,KEEROM,4565,0,3942,623,0,10,4,74,69,62,46,166,122,680,579,0,0,157,108,288,1259,0,0,1161,872,1,184,0,992,820,1812,2218
2013,8,94,9419,PAPUA,SARMI,632,0,506,107,0,7,5,36,24,17,11,9,13,54,46,0,0,72,28,22,100,0,0,173,43,0,4,0,123,99,222,220
2013,8,94,9409,PAPUA,BIAK NUMFOR,1519,0,1399,119,0,8,2,18,9,20,15,10,4,46,58,0,0,37,35,14,104,0,0,47,132,0,11,0,102,88,190,190
2013,8,94,9427,PAPUA,SUPIORI,229,0,123,37,0,3,2,9,7,6,3,6,2,15,28,0,0,21,9,8,43,0,0,60,59,0,9,0,39,42,81,128
2013,8,94,9401,PAPUA,MERAUKE,160,0,142,18,0,0,0,1,5,3,5,5,0,12,12,0,0,6,8,5,24,0,0,1,41,0,1,0,21,22,43,43
2013,8,94,9414,PAPUA,MAPPI,600,0,98,499,0,1,12,8,9,11,10,8,8,18,18,0,0,30,21,16,36,0,0,55,19,0,29,0,46,57,103,103
2013,8,94,9413,PAPUA,BOVEN DIGOEL,1291,0,931,360,0,12,9,61,53,37,28,18,25,106,116,0,0,135,65,43,222,0,0,302,125,0,39,0,234,231,465,466
2013,8,94,9404,PAPUA,NABIRE,4231,0,2606,797,0,15,21,77,94,104,111,173,191,591,767,0,0,207,215,364,1358,0,0,640,1437,0,68,0,960,1184,2144,2145
2013,8,94,9408,PAPUA,KEPULAUAN YAPEN,2323,0,1809,155,0,28,29,81,102,78,94,60,53,214,315,0,0,240,172,113,529,0,0,806,125,0,3,0,461,593,1054,934
2013,8,94,9412,PAPUA,MIMIKA,15081,0,14837,244,0,80,65,494,429,349,308,289,223,1862,1461,0,0,1068,657,512,3323,0,0,2559,2587,114,306,0,3074,2486,5560,5566
2013,8,94,9410,PAPUA,PANIAI,460,0,79,884,0,22,10,29,32,41,46,84,84,123,99,0,0,93,87,168,222,0,0,0,0,0,0,0,299,271,570,0
2013,8,94,9415,PAPUA,ASMAT,0,0,0,0,0,0,0,0,0,0,0,0,0,0,0,0,0,0,0,0,0,0,0,0,0,0,0,0,0,0,0,0
2013,8,94,9426,PAPUA,WAROPEN,769,0,493,0,0,8,10,26,25,17,17,30,20,56,60,0,0,69,34,50,116,0,0,0,0,0,0,0,137,132,269,0
2013,8,94,9402,PAPUA,JAYAWIJAYA,611,0,541,72,0,0,3,8,8,1,1,19,3,123,70,0,0,19,2,22,193,0,0,107,121,0,3,0,151,85,236,231
2013,8,94,9411,PAPUA,PUNCAK JAYA,0,0,0,0,0,0,0,0,0,0,0,0,0,0,0,0,0,0,0,0,0,0,0,0,0,0,0,0,0,0,0,0
2013,8,94,9418,PAPUA,TOLIKARA,0,0,0,0,0,0,0,0,0,0,0,0,0,0,0,0,0,0,0,0,0,0,0,0,0,0,0,0,0,0,0,0
2013,8,94,9416,PAPUA,YAHUKIMO,0,0,0,0,0,0,0,0,0,0,0,0,0,0,0,0,0,0,0,0,0,0,0,0,0,0,0,0,0,0,0,0
2013,8,94,9417,PAPUA,PEGUNUNGAN BINTANG,0,0,0,0,0,0,0,0,0,0,0,0,0,0,0,0,0,0,0,0,0,0,0,0,0,0,0,0,0,0,0,0
2013,9,91,9171,PAPUA BARAT,KOTA SORONG,1597,0,1518,79,0,13,12,26,19,25,21,26,16,51,55,0,0,70,46,42,106,0,0,91,173,0,0,0,141,123,264,264
2013,9,91,9107,PAPUA BARAT,SORONG,1142,0,842,158,0,0,3,6,1,4,3,4,2,26,18,0,0,10,7,6,44,0,6,36,23,0,11,0,40,27,67,70
2013,9,91,9106,PAPUA BARAT,SORONG SELATAN,1408,0,1303,53,0,44,44,97,92,31,38,23,20,162,151,0,0,277,69,43,313,0,0,54,653,0,5,0,357,345,702,712
2013,9,91,9108,PAPUA BARAT,RAJA AMPAT,128,0,44,25,0,1,0,1,0,2,0,0,0,17,25,0,0,2,2,0,42,0,0,0,46,0,0,0,21,25,46,46
2013,9,91,9105,PAPUA BARAT,MANOKWARI,3586,0,2524,2062,0,29,33,90,91,62,32,16,11,129,265,0,0,243,94,27,394,0,1,432,314,0,12,0,326,432,758,758
2013,9,91,9104,PAPUA BARAT,TELUK BINTUNI,123,0,106,58,0,0,0,6,5,3,0,1,1,7,5,0,0,11,3,2,12,0,0,16,5,0,4,0,17,11,28,25
2013,9,91,9103,PAPUA BARAT,TELUK WONDAMA,3382,0,2756,72,0,17,23,87,98,57,43,24,30,128,103,0,0,225,100,54,231,0,21,380,225,0,15,0,313,297,610,620
2013,9,91,9101,PAPUA BARAT,FAKFAK,750,0,735,15,0,3,3,27,29,18,26,4,15,26,31,0,0,62,44,19,57,0,40,132,48,0,2,0,78,104,182,182
2013,9,91,9102,PAPUA BARAT,KAIMANA,825,0,678,46,0,0,0,3,1,5,2,2,3,16,6,0,0,4,7,5,22,0,0,20,19,0,1,0,26,12,38,40
2013,9,94,9403,PAPUA,JAYAPURA,6602,0,6165,437,0,25,31,230,204,217,197,158,146,658,602,0,0,490,414,304,1260,0,0,1542,799,6,121,0,1288,1180,2468,2468
2013,9,94,9471,PAPUA,KOTA JAYAPURA,5718,0,5405,313,0,12,13,96,68,78,81,73,59,435,326,0,0,189,159,132,761,0,9,640,553,1,60,0,694,547,1241,1254
2013,9,94,9420,PAPUA,KEEROM,3460,0,3138,322,0,17,9,185,177,140,163,115,83,431,389,0,0,388,303,198,820,0,10,884,593,2,74,0,888,821,1709,1553
2013,9,94,9419,PAPUA,SARMI,857,0,822,20,0,1,1,46,38,31,13,9,7,63,51,0,0,86,44,16,114,0,1,202,42,0,4,0,150,110,260,248
2013,9,94,9409,PAPUA,BIAK NUMFOR,2043,0,1457,326,0,2,1,23,13,16,17,8,10,44,44,0,0,39,33,18,88,0,34,72,89,0,21,0,93,85,178,182
2013,9,94,9427,PAPUA,SUPIORI,314,0,247,67,0,6,2,16,13,7,4,4,3,14,30,0,0,37,11,7,44,0,0,59,38,0,1,0,47,52,99,98
2013,9,94,9401,PAPUA,MERAUKE,823,0,724,82,0,6,7,38,42,33,35,25,20,66,50,0,0,93,68,45,116,0,0,108,214,0,0,0,168,154,322,322
2013,9,94,9414,PAPUA,MAPPI,611,0,102,169,0,3,0,11,12,7,17,5,6,28,22,0,0,26,24,11,50,0,5,77,11,0,24,0,54,57,111,112
2013,9,94,9413,PAPUA,BOVEN DIGOEL,1306,0,1151,155,0,15,10,63,51,32,30,18,13,101,114,0,0,139,62,31,215,0,0,305,111,0,30,0,229,218,447,446
2013,9,94,9404,PAPUA,NABIRE,3313,0,2031,618,0,43,37,121,119,81,75,83,103,356,330,0,0,320,156,186,686,0,42,619,639,0,63,0,684,664,1348,1321
2013,9,94,9408,PAPUA,KEPULAUAN YAPEN,2361,0,2156,0,0,20,21,78,74,47,53,47,41,148,211,0,0,193,100,88,359,0,55,651,87,0,2,0,340,400,740,740
2013,9,94,9412,PAPUA,MIMIKA,6919,0,6701,218,0,67,56,217,235,206,188,132,106,876,668,0,0,575,394,238,1544,0,0,1336,1343,25,49,0,1498,1253,2751,2753
2013,9,94,9410,PAPUA,PANIAI,704,0,168,536,0,22,31,25,31,43,36,48,74,107,77,0,0,109,79,122,184,0,0,348,196,0,14,0,245,249,494,558
2013,9,94,9415,PAPUA,ASMAT,426,0,402,12,0,7,1,4,4,5,4,3,0,13,9,0,0,16,9,3,22,0,0,21,29,0,0,0,32,18,50,50
2013,9,94,9426,PAPUA,WAROPEN,211,0,194,0,0,4,9,12,10,10,16,17,21,39,44,0,0,35,26,38,83,0,0,154,23,0,0,0,82,100,182,177
2013,9,94,9402,PAPUA,JAYAWIJAYA,1258,0,1125,133,0,5,2,6,12,2,4,4,0,95,60,0,0,25,6,4,155,0,0,86,82,0,6,0,112,78,190,174
2013,9,94,9411,PAPUA,PUNCAK JAYA,0,0,0,0,0,0,0,0,0,0,0,0,0,0,0,0,0,0,0,0,0,0,0,0,0,0,0,0,0,0,0,0
2013,9,94,9418,PAPUA,TOLIKARA,0,0,0,0,0,0,0,0,0,0,0,0,0,0,0,0,0,0,0,0,0,0,0,0,0,0,0,0,0,0,0,0
2013,9,94,9416,PAPUA,YAHUKIMO,0,0,0,0,0,0,0,0,0,0,0,0,0,0,0,0,0,0,0,0,0,0,0,0,0,0,0,0,0,0,0,0
2013,9,94,9417,PAPUA,PEGUNUNGAN BINTANG,0,0,0,0,0,0,0,0,0,0,0,0,0,0,0,0,0,0,0,0,0,0,0,0,0,0,0,0,0,0,0,0
2013,10,91,9171,PAPUA BARAT,KOTA SORONG,1283,0,1283,0,0,4,3,19,14,22,14,11,10,31,32,0,0,40,36,21,63,0,0,115,44,0,2,0,87,73,160,161
2013,10,91,9107,PAPUA BARAT,SORONG,1213,0,854,7,0,1,1,7,4,5,7,2,0,21,34,0,0,13,12,2,55,0,0,39,27,0,6,0,36,46,82,72
2013,10,91,9106,PAPUA BARAT,SORONG SELATAN,1612,0,1455,131,0,45,39,104,103,97,60,33,28,229,246,0,0,291,157,61,475,0,0,55,890,5,0,0,508,476,984,950
2013,10,91,9108,PAPUA BARAT,RAJA AMPAT,129,0,44,25,0,1,0,0,0,1,0,2,0,17,25,0,0,1,1,2,42,0,0,0,48,0,0,0,21,25,46,48
2013,10,91,9105,PAPUA BARAT,MANOKWARI,4493,0,3955,61,0,126,111,273,270,217,161,166,124,546,488,0,0,780,378,290,1034,0,0,946,1254,0,36,0,1328,1154,2482,2236
2013,10,91,9104,PAPUA BARAT,TELUK BINTUNI,292,0,183,109,0,0,0,9,4,2,4,0,2,11,6,0,0,13,6,2,17,0,0,19,9,9,1,0,22,16,38,38
2013,10,91,9103,PAPUA BARAT,TELUK WONDAMA,3091,0,2581,510,0,21,20,106,87,82,77,75,58,115,111,0,0,234,159,133,226,0,76,270,112,2,31,0,399,353,752,415
2013,10,91,9101,PAPUA BARAT,FAKFAK,511,0,502,9,0,2,1,15,3,8,5,3,6,17,20,0,0,21,13,9,37,0,41,71,8,0,1,0,45,35,80,80
2013,10,91,9102,PAPUA BARAT,KAIMANA,700,0,607,39,0,0,1,1,2,0,1,1,2,9,10,0,0,4,1,3,19,0,0,19,9,0,0,0,11,16,27,28
2013,10,94,9403,PAPUA,JAYAPURA,4986,0,4431,527,0,16,12,148,166,158,114,113,90,486,365,0,0,342,272,203,851,0,0,458,197,5,52,0,921,747,1668,712
2013,10,94,9471,PAPUA,KOTA JAYAPURA,4355,0,5012,266,0,8,14,86,67,78,65,49,43,409,263,0,0,175,143,92,672,0,8,575,478,3,44,0,630,452,1082,1100
2013,10,94,9420,PAPUA,KEEROM,1787,0,5174,234,0,8,6,157,118,196,163,161,111,665,501,0,0,289,359,272,1166,0,14,1143,890,2,131,0,1187,899,2086,2166
2013,10,94,9419,PAPUA,SARMI,696,0,666,5,0,6,4,35,35,23,18,10,8,64,37,0,0,80,41,18,101,0,1,194,24,0,0,0,138,102,240,218
2013,10,94,9409,PAPUA,BIAK NUMFOR,1903,0,1264,394,0,3,3,20,19,19,20,12,12,37,42,0,0,45,39,24,79,0,4,75,91,0,20,0,91,96,187,186
2013,10,94,9427,PAPUA,SUPIORI,244,0,205,36,0,4,2,13,8,7,5,4,0,15,15,0,0,27,12,4,30,0,0,52,19,0,2,0,43,30,73,73
2013,10,94,9401,PAPUA,MERAUKE,655,0,547,96,0,5,5,24,29,18,22,7,6,35,40,0,0,63,40,13,75,0,0,73,118,0,0,0,89,102,191,191
2013,10,94,9414,PAPUA,MAPPI,103,0,48,55,0,1,1,4,2,6,2,0,2,8,7,0,0,8,8,2,15,0,0,24,6,0,3,0,19,14,33,33
2013,10,94,9413,PAPUA,BOVEN DIGOEL,1210,0,1118,92,0,7,9,69,50,24,27,24,19,125,128,0,0,135,51,43,253,0,1,348,94,0,25,0,249,233,482,467
2013,10,94,9404,PAPUA,NABIRE,2743,0,2282,295,0,25,14,65,51,60,46,82,103,270,293,0,0,155,106,185,563,0,24,437,555,0,33,0,502,507,1009,1025
2013,10,94,9408,PAPUA,KEPULAUAN YAPEN,0,0,0,0,0,0,0,0,0,0,0,0,0,0,0,0,0,0,0,0,0,0,0,0,0,0,0,0,0,0,0,0
2013,10,94,9412,PAPUA,MIMIKA,10059,0,9804,254,0,50,40,372,337,266,269,229,247,1470,1159,0,0,799,535,476,2629,0,0,1692,2470,62,187,0,2387,2052,4439,4411
2013,10,94,9410,PAPUA,PANIAI,791,0,269,522,0,28,23,17,32,42,45,19,43,85,70,0,0,100,87,62,155,0,0,0,0,0,0,0,191,213,404,0
2013,10,94,9415,PAPUA,ASMAT,1218,0,258,0,0,5,2,17,11,4,6,4,1,26,13,0,0,35,10,5,39,0,0,56,29,0,4,0,56,33,89,89
2013,10,94,9426,PAPUA,WAROPEN,0,0,0,0,0,0,0,0,0,0,0,0,0,0,0,0,0,0,0,0,0,0,0,0,0,0,0,0,0,0,0,0
2013,10,94,9402,PAPUA,JAYAWIJAYA,1168,0,1107,61,0,3,3,7,13,4,10,2,2,91,59,0,0,26,14,4,150,0,0,86,101,0,8,0,107,87,194,195
2013,10,94,9411,PAPUA,PUNCAK JAYA,0,0,0,0,0,0,0,0,0,0,0,0,0,0,0,0,0,0,0,0,0,0,0,0,0,0,0,0,0,0,0,0
2013,10,94,9418,PAPUA,TOLIKARA,0,0,0,0,0,0,0,0,0,0,0,0,0,0,0,0,0,0,0,0,0,0,0,0,0,0,0,0,0,0,0,0
2013,10,94,9416,PAPUA,YAHUKIMO,0,0,0,0,0,0,0,0,0,0,0,0,0,0,0,0,0,0,0,0,0,0,0,0,0,0,0,0,0,0,0,0
2013,10,94,9417,PAPUA,PEGUNUNGAN BINTANG,0,0,0,0,0,0,0,0,0,0,0,0,0,0,0,0,0,0,0,0,0,0,0,0,0,0,0,0,0,0,0,0
2013,11,91,9171,PAPUA BARAT,KOTA SORONG,1474,0,1355,2,0,4,3,16,8,15,13,10,6,43,27,0,0,31,28,16,70,0,0,80,58,0,5,0,88,57,145,143
2013,11,91,9107,PAPUA BARAT,SORONG,1981,0,1258,57,0,1,1,8,7,4,5,0,4,24,24,0,0,17,9,4,48,0,0,47,30,0,1,0,37,41,78,78
2013,11,91,9106,PAPUA BARAT,SORONG SELATAN,0,0,0,0,0,0,0,0,0,0,0,0,0,0,0,0,0,0,0,0,0,0,0,10,30,0,1,0,0,0,0,41
2013,11,91,9108,PAPUA BARAT,RAJA AMPAT,220,0,110,0,0,0,0,0,2,3,5,2,8,18,8,0,0,2,8,10,26,0,0,0,45,0,0,0,23,23,46,45
2013,11,91,9105,PAPUA BARAT,MANOKWARI,2060,0,1802,53,0,10,19,60,54,37,32,36,20,138,200,0,0,143,69,56,338,0,0,380,202,2,32,0,281,325,606,616
2013,11,91,9104,PAPUA BARAT,TELUK BINTUNI,329,0,143,150,0,0,0,1,2,3,1,1,2,4,2,0,0,3,4,3,6,0,0,4,6,0,5,0,9,7,16,15
2013,11,91,9103,PAPUA BARAT,TELUK WONDAMA,805,0,620,185,0,8,16,55,40,33,45,36,26,78,65,0,0,119,78,62,143,0,45,110,109,2,27,0,210,192,402,248
2013,11,91,9101,PAPUA BARAT,FAKFAK,1239,0,1187,52,0,16,6,63,53,42,26,21,14,65,56,0,0,138,68,35,121,0,6,336,26,0,0,0,207,155,362,362
2013,11,91,9102,PAPUA BARAT,KAIMANA,521,0,489,2,0,0,0,0,1,1,2,1,1,6,5,0,0,1,3,2,11,0,0,12,5,0,0,0,8,9,17,17
2013,11,94,9403,PAPUA,JAYAPURA,5805,0,5048,538,0,21,26,201,187,232,191,129,147,506,465,0,0,435,423,276,971,0,2,1319,490,0,117,0,1089,1016,2105,1926
2013,11,94,9471,PAPUA,KOTA JAYAPURA,5714,0,5100,335,0,12,20,84,71,73,66,42,48,353,242,0,0,187,139,90,595,0,0,500,482,2,36,0,564,447,1011,1020
2013,11,94,9420,PAPUA,KEEROM,5593,0,5299,244,0,19,22,229,149,217,199,164,109,676,465,0,0,419,416,273,1141,0,0,1265,887,0,97,0,1305,944,2249,2249
2013,11,94,9419,PAPUA,SARMI,545,0,509,11,0,3,3,32,23,20,20,5,5,37,49,0,0,61,40,10,86,0,0,183,16,0,0,0,97,100,197,199
2013,11,94,9409,PAPUA,BIAK NUMFOR,1035,0,647,255,0,2,1,20,25,26,22,14,8,31,47,0,0,48,48,22,78,0,0,47,147,3,3,0,93,103,196,200
2013,11,94,9427,PAPUA,SUPIORI,284,0,249,34,0,0,2,16,4,0,3,4,2,13,14,0,0,22,3,6,27,0,0,31,22,0,2,0,33,25,58,55
2013,11,94,9401,PAPUA,MERAUKE,450,0,237,94,0,5,3,16,16,8,13,6,5,21,20,0,0,40,21,11,41,0,0,1,112,0,0,0,56,57,113,113
2013,11,94,9414,PAPUA,MAPPI,1329,0,1184,144,0,8,15,32,31,23,23,22,21,51,26,0,0,86,46,43,77,0,19,173,43,0,36,0,136,116,252,252
2013,11,94,9413,PAPUA,BOVEN DIGOEL,1022,0,766,256,0,15,21,59,57,29,40,18,10,66,112,0,0,152,69,28,178,0,0,289,97,0,39,0,187,240,427,425
2013,11,94,9404,PAPUA,NABIRE,3066,0,2224,169,0,36,23,142,74,74,55,40,51,251,296,0,0,275,129,91,547,0,25,454,435,0,40,0,543,499,1042,929
2013,11,94,9408,PAPUA,KEPULAUAN YAPEN,0,0,0,0,0,0,0,0,0,0,0,0,0,0,0,0,0,0,0,0,0,0,0,0,0,0,0,0,0,0,0,0
2013,11,94,9412,PAPUA,MIMIKA,8886,0,8347,413,0,31,34,289,236,272,229,236,212,1588,1254,0,0,590,501,448,2842,0,0,0,0,0,0,0,2416,1965,4381,0
2013,11,94,9410,PAPUA,PANIAI,0,0,0,0,0,0,0,0,0,0,0,0,0,0,0,0,0,0,0,0,0,0,0,0,0,0,0,0,0,0,0,0
2013,11,94,9415,PAPUA,ASMAT,336,0,336,0,0,2,10,3,10,8,1,0,1,37,39,0,0,25,9,1,76,0,0,64,37,0,0,0,50,61,111,101
2013,11,94,9426,PAPUA,WAROPEN,0,0,0,0,0,0,0,0,0,0,0,0,0,0,0,0,0,0,0,0,0,0,0,0,0,0,0,0,0,0,0,0
2013,11,94,9402,PAPUA,JAYAWIJAYA,1390,0,1277,113,0,3,2,5,5,8,7,9,10,78,53,0,0,15,15,19,131,0,0,69,108,0,0,0,103,77,180,177
2013,11,94,9411,PAPUA,PUNCAK JAYA,0,0,0,0,0,0,0,0,0,0,0,0,0,0,0,0,0,0,0,0,0,0,0,0,0,0,0,0,0,0,0,0
2013,11,94,9418,PAPUA,TOLIKARA,0,0,0,0,0,0,0,0,0,0,0,0,0,0,0,0,0,0,0,0,0,0,0,0,0,0,0,0,0,0,0,0
2013,11,94,9416,PAPUA,YAHUKIMO,0,0,0,0,0,0,0,0,0,0,0,0,0,0,0,0,0,0,0,0,0,0,0,0,0,0,0,0,0,0,0,0
2013,11,94,9417,PAPUA,PEGUNUNGAN BINTANG,0,0,0,0,0,0,0,0,0,0,0,0,0,0,0,0,0,0,0,0,0,0,0,0,0,0,0,0,0,0,0,0
2013,12,91,9171,PAPUA BARAT,KOTA SORONG,2171,0,2171,0,0,12,5,40,42,33,25,33,22,97,89,0,0,99,58,55,186,0,1,120,275,0,4,0,215,183,398,399
2013,12,91,9107,PAPUA BARAT,SORONG,1541,0,1309,36,0,0,0,13,7,1,4,8,2,39,23,0,0,20,5,10,62,0,0,69,26,0,2,0,61,36,97,97
2013,12,91,9106,PAPUA BARAT,SORONG SELATAN,957,0,946,48,0,37,92,85,38,27,21,21,126,129,313,0,0,252,48,147,442,0,0,21,623,0,1,0,299,590,889,645
2013,12,91,9108,PAPUA BARAT,RAJA AMPAT,117,0,99,7,0,0,0,1,1,8,1,4,6,55,20,0,0,2,9,10,75,0,0,9,87,0,0,0,68,28,96,96
2013,12,91,9105,PAPUA BARAT,MANOKWARI,2572,0,2014,313,0,47,45,155,153,71,74,46,56,180,142,0,0,400,145,102,322,0,0,162,755,0,54,0,499,470,969,971
2013,12,91,9104,PAPUA BARAT,TELUK BINTUNI,165,0,132,33,0,0,0,0,3,1,1,1,0,10,3,0,0,3,2,1,13,0,0,6,9,0,4,0,12,7,19,19
2013,12,91,9103,PAPUA BARAT,TELUK WONDAMA,692,0,692,75,0,7,15,34,24,25,25,20,17,37,24,0,0,80,50,37,61,0,31,47,44,0,2,0,123,105,228,93
2013,12,91,9101,PAPUA BARAT,FAKFAK,756,0,730,26,0,13,4,41,38,11,10,6,2,37,22,0,0,96,21,8,59,0,0,172,11,0,1,0,108,76,184,184
2013,12,91,9102,PAPUA BARAT,KAIMANA,640,0,623,5,0,2,0,8,11,4,4,2,4,16,13,0,0,21,8,6,29,0,0,49,12,0,3,0,32,32,64,64
2013,12,94,9403,PAPUA,JAYAPURA,4806,0,4317,472,0,30,28,166,188,131,164,84,83,539,424,0,0,412,295,167,963,0,0,1192,554,1,82,0,950,887,1837,1829
2013,12,94,9471,PAPUA,KOTA JAYAPURA,5276,0,4905,371,0,11,20,78,72,76,54,40,50,349,224,0,0,181,130,90,573,0,8,470,470,2,40,0,554,420,974,982
2013,12,94,9420,PAPUA,KEEROM,3363,0,3208,155,0,9,7,138,119,140,120,110,91,296,206,0,0,273,260,201,502,0,16,764,531,0,105,0,693,543,1236,1400
2013,12,94,9419,PAPUA,SARMI,0,0,0,0,0,0,0,0,0,0,0,0,0,0,0,0,0,0,0,0,0,0,0,0,0,0,0,0,0,0,0,0
2013,12,94,9409,PAPUA,BIAK NUMFOR,0,0,0,0,0,0,0,0,0,0,0,0,0,0,0,0,0,0,0,0,0,0,0,0,0,0,0,0,0,0,0,0
2013,12,94,9427,PAPUA,SUPIORI,0,0,0,0,0,0,0,0,0,0,0,0,0,0,0,0,0,0,0,0,0,0,0,0,0,0,0,0,0,0,0,0
2013,12,94,9401,PAPUA,MERAUKE,0,0,0,0,0,0,0,0,0,0,0,0,0,0,0,0,0,0,0,0,0,0,0,0,0,0,0,0,0,0,0,0
2013,12,94,9414,PAPUA,MAPPI,216,0,145,44,0,2,4,4,4,3,8,25,9,25,10,0,0,14,11,34,35,0,0,67,9,0,17,0,59,35,94,93
2013,12,94,9413,PAPUA,BOVEN DIGOEL,718,0,591,127,0,5,7,9,22,10,15,2,6,47,35,0,0,43,25,8,82,0,0,150,10,0,17,0,73,85,158,177
2013,12,94,9404,PAPUA,NABIRE,2384,0,1608,355,0,3,6,20,25,42,50,67,84,166,200,0,0,54,92,151,366,0,0,330,277,2,49,0,298,365,663,658
2013,12,94,9408,PAPUA,KEPULAUAN YAPEN,0,0,0,0,0,0,0,0,0,0,0,0,0,0,0,0,0,0,0,0,0,0,0,0,0,0,0,0,0,0,0,0
2013,12,94,9412,PAPUA,MIMIKA,4922,0,4351,479,0,25,19,192,169,175,148,164,172,1044,794,0,0,405,323,336,1838,0,8,1211,1559,31,108,0,1600,1302,2902,2909
2013,12,94,9410,PAPUA,PANIAI,0,0,0,0,0,0,0,0,0,0,0,0,0,0,0,0,0,0,0,0,0,0,0,0,0,0,0,0,0,0,0,0
2013,12,94,9415,PAPUA,ASMAT,1141,0,869,244,0,12,14,51,49,33,28,16,14,104,74,0,0,126,61,30,178,0,3,306,82,0,55,0,216,179,395,443
2013,12,94,9426,PAPUA,WAROPEN,0,0,0,0,0,0,0,0,0,0,0,0,0,0,0,0,0,0,0,0,0,0,0,0,0,0,0,0,0,0,0,0
2013,12,94,9402,PAPUA,JAYAWIJAYA,0,0,0,0,0,0,0,0,0,0,0,0,0,0,0,0,0,0,0,0,0,0,0,0,0,0,0,0,0,0,0,0
2013,12,94,9411,PAPUA,PUNCAK JAYA,0,0,0,0,0,0,0,0,0,0,0,0,0,0,0,0,0,0,0,0,0,0,0,0,0,0,0,0,0,0,0,0
2013,12,94,9418,PAPUA,TOLIKARA,0,0,0,0,0,0,0,0,0,0,0,0,0,0,0,0,0,0,0,0,0,0,0,0,0,0,0,0,0,0,0,0
2013,12,94,9416,PAPUA,YAHUKIMO,0,0,0,0,0,0,0,0,0,0,0,0,0,0,0,0,0,0,0,0,0,0,0,0,0,0,0,0,0,0,0,0
2013,12,94,9417,PAPUA,PEGUNUNGAN BINTANG,0,0,0,0,0,0,0,0,0,0,0,0,0,0,0,0,0,0,0,0,0,0,0,0,0,0,0,0,0,0,0,0
2014,1,91,9171,PAPUA BARAT,KOTA SORONG,2509,2493,2347,146,0,23,21,44,33,46,43,43,42,89,73,0,0,121,89,85,162,0,2,112,344,0,8,0,245,212,457,464
2014,1,91,9107,PAPUA BARAT,SORONG,2074,1905,1769,136,0,3,1,14,4,6,10,6,6,61,55,0,0,22,16,12,116,0,0,99,43,0,16,0,90,76,166,158
2014,1,91,9106,PAPUA BARAT,SORONG SELATAN,905,905,805,100,0,23,33,35,33,17,14,17,40,50,142,0,0,124,31,57,192,0,0,1,291,0,0,0,142,262,404,292
2014,1,91,9108,PAPUA BARAT,RAJA AMPAT,56,30,13,17,0,1,1,1,1,1,2,4,2,12,5,0,0,4,3,6,17,0,0,0,25,0,0,0,19,11,30,25
2014,1,91,9105,PAPUA BARAT,MANOKWARI,3684,3521,3295,226,0,27,28,159,131,105,93,61,44,288,346,0,0,345,198,105,634,0,44,649,624,0,31,0,640,642,1282,1304
2014,1,91,9104,PAPUA BARAT,TELUK BINTUNI,268,268,132,136,0,1,0,7,2,2,1,2,2,5,1,0,0,10,3,4,6,0,1,4,15,0,5,0,17,6,23,24
2014,1,91,9103,PAPUA BARAT,TELUK WONDAMA,640,640,580,60,0,6,7,19,15,19,13,9,15,22,29,0,0,47,32,24,51,0,31,45,50,2,19,0,75,79,154,116
2014,1,91,9101,PAPUA BARAT,FAKFAK,1792,1776,1656,120,0,23,14,78,71,50,43,26,19,86,92,0,0,186,93,45,178,0,10,439,62,0,3,0,263,239,502,504
2014,1,91,9102,PAPUA BARAT,KAIMANA,784,752,672,80,0,0,0,1,1,3,0,0,1,2,6,0,0,2,3,1,8,0,0,11,3,0,0,0,6,8,14,14
2014,1,91,9109,PAPUA BARAT,TAMBRAUW,0,0,0,0,0,0,0,0,0,0,0,0,0,0,0,0,0,0,0,0,0,0,0,0,0,0,0,0,0,0,0,0
2014,1,91,9110,PAPUA BARAT,MAYBRAT,0,0,0,0,0,0,0,0,0,0,0,0,0,0,0,0,0,0,0,0,0,0,0,0,0,0,0,0,0,0,0,0
2014,1,94,9403,PAPUA,JAYAPURA,5641,5562,4873,689,0,23,23,172,152,174,148,139,142,524,419,0,0,370,322,281,943,0,0,1299,530,2,82,0,1032,884,1916,1913
2014,1,94,9471,PAPUA,KOTA JAYAPURA,5482,5482,5365,117,0,13,4,79,69,91,75,83,73,564,318,0,0,165,166,156,882,0,0,743,604,5,25,0,830,539,1369,1377
2014,1,94,9420,PAPUA,KEEROM,6907,6907,6282,625,0,23,9,200,198,234,237,184,136,741,575,0,0,430,471,320,1316,0,18,1521,867,0,149,0,1382,1155,2537,2537
2014,1,94,9419,PAPUA,SARMI,1045,937,685,252,0,13,9,53,39,47,36,27,30,70,72,0,0,114,83,57,142,0,1,275,65,0,13,0,210,186,396,353
2014,1,94,9409,PAPUA,BIAK NUMFOR,3770,3735,3667,68,0,45,63,27,16,16,9,404,354,467,618,0,0,151,25,758,1085,0,2,327,1716,2,5,0,959,1060,2019,2050
2014,1,94,9427,PAPUA,SUPIORI,224,210,163,47,0,5,2,5,12,3,7,2,1,10,18,0,0,24,10,3,28,0,0,45,20,0,0,0,25,40,65,65
2014,1,94,9401,PAPUA,MERAUKE,1169,1139,1080,59,0,21,21,80,77,24,34,24,21,116,112,0,0,199,58,45,228,0,0,94,436,0,0,0,265,265,530,530
2014,1,94,9414,PAPUA,MAPPI,639,360,151,209,0,3,3,16,12,7,7,5,10,13,11,0,0,34,14,15,24,0,1,67,14,0,6,0,44,43,87,87
2014,1,94,9413,PAPUA,BOVEN DIGOEL,1318,1315,1197,118,0,16,9,64,59,44,46,19,28,152,165,0,0,148,90,47,317,0,2,464,109,0,27,0,295,307,602,600
2014,1,94,9404,PAPUA,NABIRE,4757,4389,3799,590,0,22,28,83,85,91,112,81,84,370,348,0,0,218,203,165,718,0,4,578,656,1,70,0,647,657,1304,1305
2014,1,94,9408,PAPUA,KEPULAUAN YAPEN,2000,1463,1433,30,0,27,10,36,28,35,23,40,52,54,64,0,0,101,58,92,118,0,26,312,52,0,2,0,192,177,369,366
2014,1,94,9412,PAPUA,MIMIKA,8339,7686,7115,571,0,28,33,233,198,187,156,166,157,1218,1005,0,0,492,343,323,2223,0,56,1403,1621,86,298,0,1832,1549,3381,3408
2014,1,94,9410,PAPUA,PANIAI,38,37,37,0,0,1,2,3,4,4,1,0,0,6,15,0,0,10,5,0,21,0,0,24,24,0,0,0,14,22,36,48
2014,1,94,9415,PAPUA,ASMAT,2258,1568,1213,355,0,27,23,111,105,118,70,50,36,265,181,0,0,266,188,86,446,0,2,687,239,0,59,0,571,415,986,985
2014,1,94,9426,PAPUA,WAROPEN,537,537,537,0,0,6,12,26,12,26,19,18,17,101,91,0,0,56,45,35,192,0,4,348,6,0,0,0,177,151,328,354
2014,1,94,9402,PAPUA,JAYAWIJAYA,2128,2125,2034,91,0,1,3,7,8,5,3,10,4,125,63,0,0,19,8,14,188,0,0,112,116,0,0,0,148,81,229,228
2014,1,94,9411,PAPUA,PUNCAK JAYA,0,0,0,0,0,0,0,0,0,0,0,0,0,0,0,0,0,0,0,0,0,0,0,0,0,0,0,0,0,0,0,0
2014,1,94,9418,PAPUA,TOLIKARA,0,0,0,0,0,0,0,0,0,0,0,0,0,0,0,0,0,0,0,0,0,0,0,0,0,0,0,0,0,0,0,0
2014,1,94,9416,PAPUA,YAHUKIMO,0,0,0,0,0,0,0,0,0,0,0,0,0,0,0,0,0,0,0,0,0,0,0,0,0,0,0,0,0,0,0,0
2014,1,94,9417,PAPUA,PEGUNUNGAN BINTANG,0,0,0,0,0,0,0,0,0,0,0,0,0,0,0,0,0,0,0,0,0,0,0,0,0,0,0,0,0,0,0,0
2014,1,94,9428,PAPUA,MAMBERAMO RAYA,0,0,0,0,0,0,0,0,0,0,0,0,0,0,0,0,0,0,0,0,0,0,0,0,0,0,0,0,0,0,0,0
2014,1,94,9429,PAPUA,NDUGA,0,0,0,0,0,0,0,0,0,0,0,0,0,0,0,0,0,0,0,0,0,0,0,0,0,0,0,0,0,0,0,0
2014,1,94,9430,PAPUA,LANNY JAYA,0,0,0,0,0,0,0,0,0,0,0,0,0,0,0,0,0,0,0,0,0,0,0,0,0,0,0,0,0,0,0,0
2014,1,94,9431,PAPUA,MAMBERAMO TENGAH,0,0,0,0,0,0,0,0,0,0,0,0,0,0,0,0,0,0,0,0,0,0,0,0,0,0,0,0,0,0,0,0
2014,1,94,9432,PAPUA,YALIMO,0,0,0,0,0,0,0,0,0,0,0,0,0,0,0,0,0,0,0,0,0,0,0,0,0,0,0,0,0,0,0,0
2014,1,94,9433,PAPUA,PUNCAK,0,0,0,0,0,0,0,0,0,0,0,0,0,0,0,0,0,0,0,0,0,0,0,0,0,0,0,0,0,0,0,0
2014,1,94,9434,PAPUA,DOGIYAI,0,0,0,0,0,0,0,0,0,0,0,0,0,0,0,0,0,0,0,0,0,0,0,0,0,0,0,0,0,0,0,0
2014,1,94,9435,PAPUA,INTAN JAYA,0,0,0,0,0,0,0,0,0,0,0,0,0,0,0,0,0,0,0,0,0,0,0,0,0,0,0,0,0,0,0,0
2014,1,94,9436,PAPUA,DEIYAI,0,0,0,0,0,0,0,0,0,0,0,0,0,0,0,0,0,0,0,0,0,0,0,0,0,0,0,0,0,0,0,0
2014,2,91,9171,PAPUA BARAT,KOTA SORONG,1755,1628,1609,19,0,17,14,32,26,33,37,37,36,89,74,0,0,89,70,73,163,0,0,81,323,0,0,0,208,187,395,404
2014,2,91,9107,PAPUA BARAT,SORONG,1063,928,699,229,0,0,0,1,1,2,1,0,4,22,9,0,0,2,3,4,31,0,0,18,19,0,3,0,25,15,40,40
2014,2,91,9106,PAPUA BARAT,SORONG SELATAN,1402,1402,1298,104,0,57,57,50,39,43,43,23,35,101,199,0,0,203,86,58,300,0,0,124,556,0,10,0,274,373,647,690
2014,2,91,9108,PAPUA BARAT,RAJA AMPAT,70,70,39,31,0,1,3,2,3,2,3,5,5,15,5,0,0,9,5,10,20,0,0,14,30,0,0,0,25,19,44,44
2014,2,91,9105,PAPUA BARAT,MANOKWARI,3180,2849,2596,253,0,27,31,122,96,71,66,52,38,198,212,0,0,276,137,90,410,0,19,413,512,0,37,0,470,443,913,962
2014,2,91,9104,PAPUA BARAT,TELUK BINTUNI,349,349,198,151,0,0,0,0,1,0,1,0,1,11,0,0,0,1,1,1,11,0,0,6,7,0,1,0,11,3,14,14
2014,2,91,9103,PAPUA BARAT,TELUK WONDAMA,774,774,714,60,0,26,29,49,49,57,52,71,86,143,152,0,0,153,109,157,295,0,31,80,87,2,19,0,346,368,714,188
2014,2,91,9101,PAPUA BARAT,FAKFAK,1356,1340,1263,77,0,18,12,65,47,40,34,18,12,66,73,0,0,142,74,30,139,0,2,353,30,0,2,0,207,178,385,385
2014,2,91,9102,PAPUA BARAT,KAIMANA,695,647,613,34,0,0,0,0,3,1,1,1,1,10,4,0,0,3,2,2,14,0,0,8,9,0,3,0,12,9,21,20
2014,2,91,9109,PAPUA BARAT,TAMBRAUW,0,0,0,0,0,0,0,0,0,0,0,0,0,0,0,0,0,0,0,0,0,0,0,0,0,0,0,0,0,0,0,0
2014,2,91,9110,PAPUA BARAT,MAYBRAT,0,0,0,0,0,0,0,0,0,0,0,0,0,0,0,0,0,0,0,0,0,0,0,0,0,0,0,0,0,0,0,0
2014,2,94,9403,PAPUA,JAYAPURA,5417,4762,4351,411,0,26,17,140,127,169,129,91,113,335,343,0,0,310,298,204,678,0,0,984,435,0,71,0,761,729,1490,1490
2014,2,94,9471,PAPUA,KOTA JAYAPURA,6600,0,0,0,0,0,0,0,0,0,0,0,0,0,0,0,0,0,0,0,0,0,13,0,0,0,0,0,0,0,0,0
2014,2,94,9420,PAPUA,KEEROM,6374,6374,5958,416,0,14,17,202,184,250,237,231,178,944,752,0,0,417,487,409,1696,0,12,1870,959,0,180,0,1641,1368,3009,3009
2014,2,94,9419,PAPUA,SARMI,1149,1017,817,200,0,1,2,43,38,46,37,17,9,83,145,0,0,84,83,26,228,0,1,190,57,0,32,0,190,231,421,279
2014,2,94,9409,PAPUA,BIAK NUMFOR,1520,1450,1400,50,0,0,0,12,6,6,5,7,6,19,20,0,0,18,11,13,39,0,0,20,59,0,3,0,44,37,81,82
2014,2,94,9427,PAPUA,SUPIORI,279,219,209,10,0,3,3,8,10,6,2,3,2,19,17,0,0,24,8,5,36,0,0,42,31,0,1,0,39,34,73,74
2014,2,94,9401,PAPUA,MERAUKE,0,0,0,0,0,0,0,0,0,0,0,0,0,0,0,0,0,0,0,0,0,0,0,0,0,0,0,0,0,0,0,0
2014,2,94,9414,PAPUA,MAPPI,634,497,335,162,0,6,3,18,20,16,16,4,10,24,18,0,0,47,32,14,42,0,20,106,41,0,8,0,68,67,135,155
2014,2,94,9413,PAPUA,BOVEN DIGOEL,759,747,618,129,0,5,3,19,17,22,16,15,11,73,87,0,0,44,38,26,160,0,3,167,77,0,28,0,134,134,268,272
2014,2,94,9404,PAPUA,NABIRE,4143,3750,1901,1849,0,13,11,59,54,63,47,61,63,246,212,0,0,137,110,124,458,0,4,400,362,0,72,0,442,387,829,834
2014,2,94,9408,PAPUA,KEPULAUAN YAPEN,1932,1761,1635,126,0,30,22,62,44,53,48,34,37,82,162,0,0,158,101,71,244,0,4,504,63,0,8,0,261,313,574,575
2014,2,94,9412,PAPUA,MIMIKA,14154,14246,13454,792,0,6,12,439,373,323,330,252,224,1823,1481,0,0,830,653,476,3304,0,43,2079,2375,82,216,0,2843,2420,5263,4752
2014,2,94,9410,PAPUA,PANIAI,66,66,66,0,0,0,3,1,6,4,3,2,1,24,22,0,0,10,7,3,46,0,0,54,11,0,1,0,31,35,66,66
2014,2,94,9415,PAPUA,ASMAT,2211,1599,1338,261,0,35,30,99,96,105,69,53,49,252,162,0,0,260,174,102,414,0,11,655,257,0,49,0,544,406,950,961
2014,2,94,9426,PAPUA,WAROPEN,626,626,626,0,0,22,17,31,23,27,21,16,22,121,106,0,0,93,48,38,227,0,14,392,5,0,0,0,217,189,406,397
2014,2,94,9402,PAPUA,JAYAWIJAYA,2069,2069,1963,106,0,0,0,8,6,4,3,1,0,30,21,0,0,14,7,1,51,0,0,22,50,0,1,0,43,30,73,73
2014,2,94,9411,PAPUA,PUNCAK JAYA,0,0,0,0,0,0,0,0,0,0,0,0,0,0,0,0,0,0,0,0,0,0,0,0,0,0,0,0,0,0,0,0
2014,2,94,9418,PAPUA,TOLIKARA,0,0,0,0,0,0,0,0,0,0,0,0,0,0,0,0,0,0,0,0,0,0,0,0,0,0,0,0,0,0,0,0
2014,2,94,9416,PAPUA,YAHUKIMO,0,0,0,0,0,0,0,0,0,0,0,0,0,0,0,0,0,0,0,0,0,0,0,0,0,0,0,0,0,0,0,0
2014,2,94,9417,PAPUA,PEGUNUNGAN BINTANG,0,0,0,0,0,0,0,0,0,0,0,0,0,0,0,0,0,0,0,0,0,0,0,0,0,0,0,0,0,0,0,0
2014,2,94,9428,PAPUA,MAMBERAMO RAYA,0,0,0,0,0,0,0,0,0,0,0,0,0,0,0,0,0,0,0,0,0,0,0,0,0,0,0,0,0,0,0,0
2014,2,94,9429,PAPUA,NDUGA,0,0,0,0,0,0,0,0,0,0,0,0,0,0,0,0,0,0,0,0,0,0,0,0,0,0,0,0,0,0,0,0
2014,2,94,9430,PAPUA,LANNY JAYA,0,0,0,0,0,0,0,0,0,0,0,0,0,0,0,0,0,0,0,0,0,0,0,0,0,0,0,0,0,0,0,0
2014,2,94,9431,PAPUA,MAMBERAMO TENGAH,0,0,0,0,0,0,0,0,0,0,0,0,0,0,0,0,0,0,0,0,0,0,0,0,0,0,0,0,0,0,0,0
2014,2,94,9432,PAPUA,YALIMO,0,0,0,0,0,0,0,0,0,0,0,0,0,0,0,0,0,0,0,0,0,0,0,0,0,0,0,0,0,0,0,0
2014,2,94,9433,PAPUA,PUNCAK,0,0,0,0,0,0,0,0,0,0,0,0,0,0,0,0,0,0,0,0,0,0,0,0,0,0,0,0,0,0,0,0
2014,2,94,9434,PAPUA,DOGIYAI,0,0,0,0,0,0,0,0,0,0,0,0,0,0,0,0,0,0,0,0,0,0,0,0,0,0,0,0,0,0,0,0
2014,2,94,9435,PAPUA,INTAN JAYA,0,0,0,0,0,0,0,0,0,0,0,0,0,0,0,0,0,0,0,0,0,0,0,0,0,0,0,0,0,0,0,0
2014,2,94,9436,PAPUA,DEIYAI,0,0,0,0,0,0,0,0,0,0,0,0,0,0,0,0,0,0,0,0,0,0,0,0,0,0,0,0,0,0,0,0
2014,3,91,9171,PAPUA BARAT,KOTA SORONG,1384,1476,1460,16,0,10,7,25,24,24,27,24,22,48,30,0,0,66,51,46,78,0,0,73,159,6,3,0,131,110,241,241
2014,3,91,9107,PAPUA BARAT,SORONG,766,722,605,117,0,0,0,2,5,2,3,1,1,13,9,0,0,7,5,2,22,0,1,22,13,0,1,0,18,18,36,36
2014,3,91,9106,PAPUA BARAT,SORONG SELATAN,1839,1842,1623,219,0,19,20,62,72,59,73,52,57,136,150,0,0,173,132,109,286,0,0,106,594,0,8,0,328,372,700,708
2014,3,91,9108,PAPUA BARAT,RAJA AMPAT,20,20,20,0,0,0,0,0,0,0,0,0,0,15,5,0,0,0,0,0,20,0,0,0,20,0,0,0,15,5,20,20
2014,3,91,9105,PAPUA BARAT,MANOKWARI,2135,2005,1723,282,0,28,30,93,83,54,61,28,23,149,177,0,0,234,115,51,326,0,1,322,356,0,54,0,352,374,726,732
2014,3,91,9104,PAPUA BARAT,TELUK BINTUNI,277,277,193,84,0,0,1,3,2,1,0,0,0,10,3,0,0,6,1,0,13,0,1,2,13,0,7,0,14,6,20,22
2014,3,91,9103,PAPUA BARAT,TELUK WONDAMA,888,286,226,60,0,11,14,30,39,24,22,12,16,61,60,0,0,94,46,28,121,0,31,84,113,2,19,0,138,151,289,218
2014,3,91,9101,PAPUA BARAT,FAKFAK,1213,1213,1162,51,0,20,15,71,65,37,30,12,12,49,50,0,0,171,67,24,99,0,41,325,35,0,1,0,189,172,361,361
2014,3,91,9102,PAPUA BARAT,KAIMANA,723,636,560,76,0,2,0,2,6,1,2,2,2,7,3,0,0,10,3,4,10,0,0,11,13,0,3,0,14,13,27,27
2014,3,91,9109,PAPUA BARAT,TAMBRAUW,0,0,0,0,0,0,0,0,0,0,0,0,0,0,0,0,0,0,0,0,0,0,0,0,0,0,0,0,0,0,0,0
2014,3,91,9110,PAPUA BARAT,MAYBRAT,0,0,0,0,0,0,0,0,0,0,0,0,0,0,0,0,0,0,0,0,0,0,0,0,0,0,0,0,0,0,0,0
2014,3,94,9403,PAPUA,JAYAPURA,6208,6068,5310,758,0,13,28,191,182,188,189,120,133,578,516,0,0,414,377,253,1094,0,0,1399,623,16,101,0,1090,1048,2138,2139
2014,3,94,9471,PAPUA,KOTA JAYAPURA,6940,6137,5977,160,0,13,9,94,70,108,87,67,65,481,311,0,0,186,195,132,792,0,8,650,555,7,58,0,763,542,1305,1270
2014,3,94,9420,PAPUA,KEEROM,6161,5713,5589,124,0,26,19,151,215,221,173,181,151,626,591,0,0,411,394,332,1217,0,10,1461,773,0,160,0,1205,1149,2354,2394
2014,3,94,9419,PAPUA,SARMI,1103,995,814,181,0,11,6,50,41,49,39,19,17,72,68,0,0,108,88,36,140,0,8,294,68,0,11,0,201,171,372,373
2014,3,94,9409,PAPUA,BIAK NUMFOR,1708,1676,1540,136,0,6,7,26,33,15,23,17,9,26,48,0,0,72,38,26,74,0,2,44,161,0,4,0,90,120,210,209
2014,3,94,9427,PAPUA,SUPIORI,334,321,306,15,0,6,4,17,19,8,7,1,1,29,12,0,0,46,15,2,41,0,0,58,42,0,3,0,61,43,104,103
2014,3,94,9401,PAPUA,MERAUKE,0,0,0,0,0,0,0,0,0,0,0,0,0,0,0,0,0,0,0,0,0,0,0,0,0,0,0,0,0,0,0,0
2014,3,94,9414,PAPUA,MAPPI,454,283,95,188,0,11,10,20,12,5,3,10,10,15,11,0,0,53,8,20,26,0,0,76,25,0,6,0,61,46,107,107
2014,3,94,9413,PAPUA,BOVEN DIGOEL,1029,993,847,146,0,5,15,63,36,39,54,13,9,118,139,0,0,119,93,22,257,0,0,336,128,0,30,0,238,253,491,494
2014,3,94,9404,PAPUA,NABIRE,3798,3798,2779,1019,0,19,27,91,78,77,75,86,94,291,315,0,0,215,152,180,606,0,3,602,480,0,69,0,564,589,1153,1151
2014,3,94,9408,PAPUA,KEPULAUAN YAPEN,1847,1388,1289,99,0,37,25,72,66,38,39,26,21,63,143,0,0,200,77,47,206,0,37,467,59,0,4,0,236,294,530,530
2014,3,94,9412,PAPUA,MIMIKA,11583,12252,11653,599,0,34,22,217,185,194,167,142,157,1430,1081,0,0,458,361,299,2511,0,13,1597,1831,32,148,0,2017,1612,3629,3608
2014,3,94,9410,PAPUA,PANIAI,89,89,89,0,0,6,1,9,14,3,8,4,2,18,24,0,0,30,11,6,42,0,0,83,5,0,1,0,40,49,89,89
2014,3,94,9415,PAPUA,ASMAT,1147,730,713,17,0,26,20,56,68,29,37,21,21,79,122,0,0,170,66,42,201,0,7,230,153,0,12,0,211,268,479,395
2014,3,94,9426,PAPUA,WAROPEN,576,576,576,0,0,14,10,24,33,13,22,15,17,77,117,0,0,81,35,32,194,0,11,341,12,0,0,0,143,199,342,353
2014,3,94,9402,PAPUA,JAYAWIJAYA,2224,2136,2024,112,0,8,8,18,13,8,4,5,7,88,71,0,0,47,12,12,159,0,0,92,137,0,1,0,127,103,230,230
2014,3,94,9411,PAPUA,PUNCAK JAYA,0,0,0,0,0,0,0,0,0,0,0,0,0,0,0,0,0,0,0,0,0,0,0,0,0,0,0,0,0,0,0,0
2014,3,94,9418,PAPUA,TOLIKARA,0,0,0,0,0,0,0,0,0,0,0,0,0,0,0,0,0,0,0,0,0,0,0,0,0,0,0,0,0,0,0,0
2014,3,94,9416,PAPUA,YAHUKIMO,0,0,0,0,0,0,0,0,0,0,0,0,0,0,0,0,0,0,0,0,0,0,0,0,0,0,0,0,0,0,0,0
2014,3,94,9417,PAPUA,PEGUNUNGAN BINTANG,0,0,0,0,0,0,0,0,0,0,0,0,0,0,0,0,0,0,0,0,0,0,0,0,0,0,0,0,0,0,0,0
2014,3,94,9428,PAPUA,MAMBERAMO RAYA,0,0,0,0,0,0,0,0,0,0,0,0,0,0,0,0,0,0,0,0,0,0,0,0,0,0,0,0,0,0,0,0
2014,3,94,9429,PAPUA,NDUGA,0,0,0,0,0,0,0,0,0,0,0,0,0,0,0,0,0,0,0,0,0,0,0,0,0,0,0,0,0,0,0,0
2014,3,94,9430,PAPUA,LANNY JAYA,0,0,0,0,0,0,0,0,0,0,0,0,0,0,0,0,0,0,0,0,0,0,0,0,0,0,0,0,0,0,0,0
2014,3,94,9431,PAPUA,MAMBERAMO TENGAH,0,0,0,0,0,0,0,0,0,0,0,0,0,0,0,0,0,0,0,0,0,0,0,0,0,0,0,0,0,0,0,0
2014,3,94,9432,PAPUA,YALIMO,0,0,0,0,0,0,0,0,0,0,0,0,0,0,0,0,0,0,0,0,0,0,0,0,0,0,0,0,0,0,0,0
2014,3,94,9433,PAPUA,PUNCAK,0,0,0,0,0,0,0,0,0,0,0,0,0,0,0,0,0,0,0,0,0,0,0,0,0,0,0,0,0,0,0,0
2014,3,94,9434,PAPUA,DOGIYAI,0,0,0,0,0,0,0,0,0,0,0,0,0,0,0,0,0,0,0,0,0,0,0,0,0,0,0,0,0,0,0,0
2014,3,94,9435,PAPUA,INTAN JAYA,0,0,0,0,0,0,0,0,0,0,0,0,0,0,0,0,0,0,0,0,0,0,0,0,0,0,0,0,0,0,0,0
2014,3,94,9436,PAPUA,DEIYAI,0,0,0,0,0,0,0,0,0,0,0,0,0,0,0,0,0,0,0,0,0,0,0,0,0,0,0,0,0,0,0,0
2014,4,91,9171,PAPUA BARAT,KOTA SORONG,1703,1538,1510,28,0,10,5,23,21,26,25,28,25,37,22,0,0,59,51,53,59,0,0,52,164,0,6,0,124,98,222,222
2014,4,91,9107,PAPUA BARAT,SORONG,1886,1836,745,1091,0,0,0,12,8,11,5,10,4,66,11,0,0,20,16,14,77,0,0,34,14,0,9,0,99,28,127,57
2014,4,91,9106,PAPUA BARAT,SORONG SELATAN,825,825,704,121,0,18,22,24,23,12,16,3,9,19,14,0,0,87,28,12,33,0,0,7,150,0,0,0,76,84,160,157
2014,4,91,9108,PAPUA BARAT,RAJA AMPAT,42,42,30,12,0,1,0,0,1,2,6,1,2,20,9,0,0,2,8,3,29,0,0,41,0,0,0,0,24,18,42,41
2014,4,91,9105,PAPUA BARAT,MANOKWARI,1487,1469,1399,70,0,16,20,51,49,23,20,11,15,61,53,0,0,136,43,26,114,0,2,102,189,0,30,0,162,157,319,321
2014,4,91,9104,PAPUA BARAT,TELUK BINTUNI,169,169,97,72,0,0,1,3,2,1,0,0,4,11,4,0,0,6,1,4,15,0,1,8,12,0,6,0,15,11,26,26
2014,4,91,9103,PAPUA BARAT,TELUK WONDAMA,1072,1072,862,210,0,9,39,78,81,118,103,139,100,87,149,0,0,207,221,239,236,0,35,133,100,2,19,0,431,472,903,254
2014,4,91,9101,PAPUA BARAT,FAKFAK,98,98,82,16,0,0,3,4,2,4,3,0,0,9,4,0,0,9,7,0,13,0,1,25,3,0,2,0,17,12,29,30
2014,4,91,9102,PAPUA BARAT,KAIMANA,875,706,556,150,0,0,0,3,7,5,3,3,0,19,5,0,0,10,8,3,24,0,2,22,13,0,9,0,30,15,45,44
2014,4,91,9109,PAPUA BARAT,TAMBRAUW,0,0,0,0,0,0,0,0,0,0,0,0,0,0,0,0,0,0,0,0,0,0,0,0,0,0,0,0,0,0,0,0
2014,4,91,9110,PAPUA BARAT,MAYBRAT,0,0,0,0,0,0,0,0,0,0,0,0,0,0,0,0,0,0,0,0,0,0,0,0,0,0,0,0,0,0,0,0
2014,4,94,9403,PAPUA,JAYAPURA,6280,6275,5184,1091,0,25,28,190,220,212,235,139,126,775,567,0,0,463,447,265,1342,0,0,1522,787,3,207,0,1341,1176,2517,2519
2014,4,94,9471,PAPUA,KOTA JAYAPURA,6482,6475,5642,833,0,12,16,90,73,80,74,55,64,415,317,0,0,191,154,119,732,0,9,729,402,10,58,0,652,544,1196,1199
2014,4,94,9420,PAPUA,KEEROM,1503,1503,1307,196,0,4,2,56,57,51,48,32,21,115,82,0,0,119,99,53,197,0,7,276,175,0,17,0,258,210,468,468
2014,4,94,9419,PAPUA,SARMI,1046,859,719,140,0,5,5,44,41,43,33,19,17,64,75,0,0,95,76,36,139,0,13,294,26,0,44,0,175,171,346,364
2014,4,94,9409,PAPUA,BIAK NUMFOR,1689,1679,1588,91,0,7,5,31,18,10,13,10,7,21,48,0,0,61,23,17,69,0,0,46,123,0,1,0,79,91,170,170
2014,4,94,9427,PAPUA,SUPIORI,435,397,378,19,0,10,0,12,10,9,4,3,4,37,27,0,0,32,13,7,64,0,1,59,49,0,2,0,71,45,116,110
2014,4,94,9401,PAPUA,MERAUKE,1058,924,859,65,0,14,14,67,51,42,32,22,8,130,131,0,0,146,74,30,261,0,0,6,471,33,1,0,275,236,511,511
2014,4,94,9414,PAPUA,MAPPI,210,78,5,73,0,1,1,2,1,4,3,0,2,18,9,0,0,5,7,2,27,0,0,26,4,0,11,0,25,16,41,41
2014,4,94,9413,PAPUA,BOVEN DIGOEL,865,865,622,243,0,15,4,58,43,42,35,22,32,83,115,0,0,120,77,54,198,0,0,236,131,0,55,0,220,229,449,422
2014,4,94,9404,PAPUA,NABIRE,3936,3869,2391,1478,0,42,36,107,94,80,71,62,56,408,358,0,0,279,151,118,766,0,9,731,456,2,87,0,699,615,1314,1276
2014,4,94,9408,PAPUA,KEPULAUAN YAPEN,1707,1412,1221,191,0,38,21,56,43,42,46,46,29,61,133,0,0,158,88,75,194,0,30,481,25,0,9,0,243,272,515,515
2014,4,94,9412,PAPUA,MIMIKA,10388,10369,10080,289,0,55,36,353,292,268,214,157,131,1076,1065,0,0,736,482,288,2141,0,14,1829,1541,143,168,0,1909,1738,3647,3681
2014,4,94,9410,PAPUA,PANIAI,99,99,99,0,0,4,8,11,11,2,8,3,1,12,29,0,0,34,10,4,41,0,0,76,0,0,0,0,32,57,89,76
2014,4,94,9415,PAPUA,ASMAT,1819,1154,864,290,0,29,24,114,107,57,59,24,26,194,175,0,0,274,116,50,369,0,12,479,252,8,77,0,418,391,809,816
2014,4,94,9426,PAPUA,WAROPEN,408,408,408,0,0,17,12,32,19,16,7,6,5,63,77,0,0,80,23,11,140,0,2,243,13,0,0,0,134,120,254,256
2014,4,94,9402,PAPUA,JAYAWIJAYA,2244,2244,2110,134,0,0,1,9,4,5,2,1,2,76,56,0,0,14,7,3,132,0,0,63,93,0,1,0,91,65,156,157
2014,4,94,9411,PAPUA,PUNCAK JAYA,0,0,0,0,0,0,0,0,0,0,0,0,0,0,0,0,0,0,0,0,0,0,0,0,0,0,0,0,0,0,0,0
2014,4,94,9418,PAPUA,TOLIKARA,0,0,0,0,0,0,0,0,0,0,0,0,0,0,0,0,0,0,0,0,0,0,0,0,0,0,0,0,0,0,0,0
2014,4,94,9416,PAPUA,YAHUKIMO,0,0,0,0,0,0,0,0,0,0,0,0,0,0,0,0,0,0,0,0,0,0,0,0,0,0,0,0,0,0,0,0
2014,4,94,9417,PAPUA,PEGUNUNGAN BINTANG,0,0,0,0,0,0,0,0,0,0,0,0,0,0,0,0,0,0,0,0,0,0,0,0,0,0,0,0,0,0,0,0
2014,4,94,9428,PAPUA,MAMBERAMO RAYA,0,0,0,0,0,0,0,0,0,0,0,0,0,0,0,0,0,0,0,0,0,0,0,0,0,0,0,0,0,0,0,0
2014,4,94,9429,PAPUA,NDUGA,0,0,0,0,0,0,0,0,0,0,0,0,0,0,0,0,0,0,0,0,0,0,0,0,0,0,0,0,0,0,0,0
2014,4,94,9430,PAPUA,LANNY JAYA,0,0,0,0,0,0,0,0,0,0,0,0,0,0,0,0,0,0,0,0,0,0,0,0,0,0,0,0,0,0,0,0
2014,4,94,9431,PAPUA,MAMBERAMO TENGAH,0,0,0,0,0,0,0,0,0,0,0,0,0,0,0,0,0,0,0,0,0,0,0,0,0,0,0,0,0,0,0,0
2014,4,94,9432,PAPUA,YALIMO,0,0,0,0,0,0,0,0,0,0,0,0,0,0,0,0,0,0,0,0,0,0,0,0,0,0,0,0,0,0,0,0
2014,4,94,9433,PAPUA,PUNCAK,0,0,0,0,0,0,0,0,0,0,0,0,0,0,0,0,0,0,0,0,0,0,0,0,0,0,0,0,0,0,0,0
2014,4,94,9434,PAPUA,DOGIYAI,0,0,0,0,0,0,0,0,0,0,0,0,0,0,0,0,0,0,0,0,0,0,0,0,0,0,0,0,0,0,0,0
2014,4,94,9435,PAPUA,INTAN JAYA,0,0,0,0,0,0,0,0,0,0,0,0,0,0,0,0,0,0,0,0,0,0,0,0,0,0,0,0,0,0,0,0
2014,4,94,9436,PAPUA,DEIYAI,0,0,0,0,0,0,0,0,0,0,0,0,0,0,0,0,0,0,0,0,0,0,0,0,0,0,0,0,0,0,0,0
2014,5,91,9171,PAPUA BARAT,KOTA SORONG,1695,1695,1695,0,0,12,10,50,37,37,29,35,31,67,41,0,0,109,66,66,108,0,0,110,231,0,4,0,201,148,349,345
2014,5,91,9107,PAPUA BARAT,SORONG,955,896,810,86,0,0,1,7,8,5,5,5,4,30,18,0,0,16,10,9,48,0,0,23,28,0,28,0,47,36,83,79
2014,5,91,9106,PAPUA BARAT,SORONG SELATAN,843,823,791,32,0,11,29,19,24,15,24,5,9,37,43,0,0,83,39,14,80,0,0,9,205,0,2,0,87,129,216,216
2014,5,91,9108,PAPUA BARAT,RAJA AMPAT,35,35,23,12,0,1,0,0,1,0,6,1,1,14,10,0,0,2,6,2,24,0,0,0,41,0,0,0,16,18,34,41
2014,5,91,9105,PAPUA BARAT,MANOKWARI,2279,2080,2005,75,0,9,4,50,41,36,30,14,11,60,61,0,0,104,66,25,121,0,0,102,196,0,19,0,169,147,316,317
2014,5,91,9104,PAPUA BARAT,TELUK BINTUNI,97,97,60,37,0,0,0,0,0,0,0,0,0,1,3,0,0,0,0,0,4,0,0,2,2,0,0,0,1,3,4,4
2014,5,91,9103,PAPUA BARAT,TELUK WONDAMA,1006,915,910,5,0,22,110,79,117,121,125,101,78,122,107,0,0,328,246,179,229,0,1,137,118,0,5,0,445,537,982,260
2014,5,91,9101,PAPUA BARAT,FAKFAK,950,949,802,147,0,13,16,61,48,36,18,13,11,46,43,0,0,138,54,24,89,0,0,419,27,0,1,0,169,136,305,447
2014,5,91,9102,PAPUA BARAT,KAIMANA,621,587,561,26,0,0,0,1,4,5,1,1,1,13,3,0,0,5,6,2,16,0,0,9,16,0,4,0,20,9,29,29
2014,5,91,9109,PAPUA BARAT,TAMBRAUW,0,0,0,0,0,0,0,0,0,0,0,0,0,0,0,0,0,0,0,0,0,0,0,0,0,0,0,0,0,0,0,0
2014,5,91,9110,PAPUA BARAT,MAYBRAT,0,0,0,0,0,0,0,0,0,0,0,0,0,0,0,0,0,0,0,0,0,0,0,0,0,0,0,0,0,0,0,0
2014,5,94,9403,PAPUA,JAYAPURA,5119,5119,4288,831,0,23,18,170,149,197,177,127,112,630,391,0,0,360,374,239,1021,0,0,1264,588,5,137,0,1147,847,1994,1994
2014,5,94,9471,PAPUA,KOTA JAYAPURA,6763,6763,5863,900,0,9,11,99,70,81,84,76,45,514,331,0,0,189,165,121,845,0,4,779,492,3,52,0,779,541,1320,1326
2014,5,94,9420,PAPUA,KEEROM,1400,1400,1267,133,0,8,3,48,40,46,47,33,26,105,94,0,0,99,93,59,199,0,11,272,157,1,20,0,240,210,450,450
2014,5,94,9419,PAPUA,SARMI,1100,797,643,154,0,2,4,44,33,37,34,22,21,63,71,0,0,83,71,43,134,0,9,250,62,8,24,0,168,163,331,344
2014,5,94,9409,PAPUA,BIAK NUMFOR,1378,1369,1334,35,0,0,1,8,4,5,3,2,1,14,16,0,0,13,8,3,30,0,0,6,45,0,3,0,29,25,54,54
2014,5,94,9427,PAPUA,SUPIORI,411,354,316,38,0,3,6,22,9,11,13,12,4,51,51,0,0,40,24,16,102,0,0,98,77,0,2,0,99,83,182,177
2014,5,94,9401,PAPUA,MERAUKE,825,826,703,123,0,9,18,65,42,40,19,20,28,57,51,0,0,134,59,48,108,0,0,8,234,0,0,0,191,158,349,242
2014,5,94,9414,PAPUA,MAPPI,332,192,95,97,0,4,5,10,4,5,3,2,1,9,7,0,0,23,8,3,16,0,0,32,12,0,6,0,30,20,50,50
2014,5,94,9413,PAPUA,BOVEN DIGOEL,730,742,625,117,0,9,17,44,41,27,30,13,9,105,110,0,0,111,57,22,215,0,0,249,122,0,35,0,198,207,405,406
2014,5,94,9404,PAPUA,NABIRE,3348,2927,1954,973,0,50,32,93,100,69,74,28,31,233,242,0,0,275,143,59,475,0,15,606,290,1,38,0,473,479,952,935
2014,5,94,9408,PAPUA,KEPULAUAN YAPEN,1889,1419,1318,101,0,34,25,43,50,52,51,46,46,80,134,0,0,152,103,92,214,0,17,515,43,0,3,0,255,306,561,561
2014,5,94,9412,PAPUA,MIMIKA,11373,11373,11344,29,0,50,51,359,279,267,233,202,176,1525,1237,0,0,739,500,378,2762,0,24,2521,1650,90,96,0,2403,1976,4379,4357
2014,5,94,9410,PAPUA,PANIAI,101,101,101,0,0,10,5,11,9,9,3,2,2,18,27,0,0,35,12,4,45,0,0,90,4,1,1,0,50,46,96,96
2014,5,94,9415,PAPUA,ASMAT,1432,1354,1044,310,0,23,44,72,75,45,31,20,72,101,70,0,0,214,76,92,171,0,0,325,147,0,81,0,261,292,553,553
2014,5,94,9426,PAPUA,WAROPEN,484,484,484,0,0,8,14,24,20,15,15,18,9,70,91,0,0,66,30,27,161,0,2,279,7,0,0,0,135,149,284,286
2014,5,94,9402,PAPUA,JAYAWIJAYA,1964,1964,1827,137,0,0,0,6,2,4,5,2,0,57,35,0,0,8,9,2,92,0,0,40,70,0,0,0,69,42,111,110
2014,5,94,9411,PAPUA,PUNCAK JAYA,0,0,0,0,0,0,0,0,0,0,0,0,0,0,0,0,0,0,0,0,0,0,0,0,0,0,0,0,0,0,0,0
2014,5,94,9418,PAPUA,TOLIKARA,0,0,0,0,0,0,0,0,0,0,0,0,0,0,0,0,0,0,0,0,0,0,0,0,0,0,0,0,0,0,0,0
2014,5,94,9416,PAPUA,YAHUKIMO,0,0,0,0,0,0,0,0,0,0,0,0,0,0,0,0,0,0,0,0,0,0,0,0,0,0,0,0,0,0,0,0
2014,5,94,9417,PAPUA,PEGUNUNGAN BINTANG,0,0,0,0,0,0,0,0,0,0,0,0,0,0,0,0,0,0,0,0,0,0,0,0,0,0,0,0,0,0,0,0
2014,5,94,9428,PAPUA,MAMBERAMO RAYA,0,0,0,0,0,0,0,0,0,0,0,0,0,0,0,0,0,0,0,0,0,0,0,0,0,0,0,0,0,0,0,0
2014,5,94,9429,PAPUA,NDUGA,0,0,0,0,0,0,0,0,0,0,0,0,0,0,0,0,0,0,0,0,0,0,0,0,0,0,0,0,0,0,0,0
2014,5,94,9430,PAPUA,LANNY JAYA,0,0,0,0,0,0,0,0,0,0,0,0,0,0,0,0,0,0,0,0,0,0,0,0,0,0,0,0,0,0,0,0
2014,5,94,9431,PAPUA,MAMBERAMO TENGAH,0,0,0,0,0,0,0,0,0,0,0,0,0,0,0,0,0,0,0,0,0,0,0,0,0,0,0,0,0,0,0,0
2014,5,94,9432,PAPUA,YALIMO,0,0,0,0,0,0,0,0,0,0,0,0,0,0,0,0,0,0,0,0,0,0,0,0,0,0,0,0,0,0,0,0
2014,5,94,9433,PAPUA,PUNCAK,0,0,0,0,0,0,0,0,0,0,0,0,0,0,0,0,0,0,0,0,0,0,0,0,0,0,0,0,0,0,0,0
2014,5,94,9434,PAPUA,DOGIYAI,0,0,0,0,0,0,0,0,0,0,0,0,0,0,0,0,0,0,0,0,0,0,0,0,0,0,0,0,0,0,0,0
2014,5,94,9435,PAPUA,INTAN JAYA,0,0,0,0,0,0,0,0,0,0,0,0,0,0,0,0,0,0,0,0,0,0,0,0,0,0,0,0,0,0,0,0
2014,5,94,9436,PAPUA,DEIYAI,0,0,0,0,0,0,0,0,0,0,0,0,0,0,0,0,0,0,0,0,0,0,0,0,0,0,0,0,0,0,0,0
2014,6,91,9171,PAPUA BARAT,KOTA SORONG,1676,1676,1676,0,0,8,6,27,18,23,29,32,18,54,31,0,0,59,52,50,85,0,0,75,155,0,5,0,144,102,246,235
2014,6,91,9107,PAPUA BARAT,SORONG,1739,1719,1340,379,0,1,0,1,4,3,5,5,1,28,12,0,0,6,8,6,40,0,0,26,23,0,11,0,38,22,60,60
2014,6,91,9106,PAPUA BARAT,SORONG SELATAN,589,582,494,88,0,9,15,17,16,8,10,9,3,20,24,0,0,57,18,12,44,0,0,10,113,0,0,0,63,68,131,123
2014,6,91,9108,PAPUA BARAT,RAJA AMPAT,120,120,120,0,0,1,1,2,1,0,6,0,10,9,4,0,0,5,6,10,13,0,0,8,22,0,4,0,12,22,34,34
2014,6,91,9105,PAPUA BARAT,MANOKWARI,914,722,702,20,0,3,3,11,16,13,6,9,10,48,48,0,0,33,19,19,96,0,0,71,85,0,10,0,84,83,167,166
2014,6,91,9104,PAPUA BARAT,TELUK BINTUNI,110,110,90,20,0,0,0,0,0,1,0,1,0,0,0,0,0,0,1,1,0,0,0,1,2,0,0,0,2,0,2,3
2014,6,91,9103,PAPUA BARAT,TELUK WONDAMA,916,916,916,0,0,22,107,79,117,121,125,101,78,122,106,0,0,325,246,179,228,0,1,133,122,0,4,0,445,533,978,259
2014,6,91,9101,PAPUA BARAT,FAKFAK,420,420,305,115,0,3,2,7,5,13,10,4,16,12,11,0,0,17,23,20,23,0,0,27,53,0,3,0,39,44,83,83
2014,6,91,9102,PAPUA BARAT,KAIMANA,672,648,567,81,0,0,0,2,2,2,2,6,0,18,4,0,0,4,4,6,22,0,0,20,15,0,1,0,28,8,36,36
2014,6,91,9109,PAPUA BARAT,TAMBRAUW,0,0,0,0,0,0,0,0,0,0,0,0,0,0,0,0,0,0,0,0,0,0,0,0,0,0,0,0,0,0,0,0
2014,6,91,9110,PAPUA BARAT,MAYBRAT,0,0,0,0,0,0,0,0,0,0,0,0,0,0,0,0,0,0,0,0,0,0,0,0,0,0,0,0,0,0,0,0
2014,6,94,9403,PAPUA,JAYAPURA,5888,5891,4981,910,0,22,13,199,212,229,185,146,130,586,435,0,0,446,414,276,1021,0,0,1439,525,7,186,0,1182,975,2157,2157
2014,6,94,9471,PAPUA,KOTA JAYAPURA,7741,6648,4978,1670,0,7,7,78,81,118,94,74,75,488,295,0,0,173,212,149,783,0,0,816,450,9,47,0,765,552,1317,1322
2014,6,94,9420,PAPUA,KEEROM,3338,1742,1072,670,0,17,5,105,80,97,114,83,64,361,302,0,0,207,211,147,663,0,4,797,383,0,48,0,663,565,1228,1228
2014,6,94,9419,PAPUA,SARMI,1208,965,717,248,0,4,1,42,36,43,39,26,24,75,80,0,0,83,82,50,155,0,14,266,49,0,53,0,190,180,370,368
2014,6,94,9409,PAPUA,BIAK NUMFOR,1621,1621,1558,63,0,6,5,7,12,9,8,12,8,16,31,0,0,30,17,20,47,0,0,9,96,0,3,0,50,64,114,108
2014,6,94,9427,PAPUA,SUPIORI,424,424,364,60,0,3,3,16,16,9,3,1,3,37,43,0,0,38,12,4,80,0,0,56,74,0,2,0,66,68,134,132
2014,6,94,9401,PAPUA,MERAUKE,1049,871,838,33,0,3,1,55,50,38,32,30,27,104,104,0,0,109,70,57,208,0,0,134,310,0,0,0,230,214,444,444
2014,6,94,9414,PAPUA,MAPPI,329,329,266,63,0,2,0,0,3,2,0,3,0,5,8,0,0,5,2,3,13,0,0,7,16,0,0,0,12,11,23,23
2014,6,94,9413,PAPUA,BOVEN DIGOEL,786,786,604,182,0,12,11,38,50,28,31,10,8,70,122,0,0,111,59,18,192,0,0,209,134,0,38,0,158,222,380,381
2014,6,94,9404,PAPUA,NABIRE,8122,7762,6668,1094,0,40,34,93,104,87,101,76,69,406,385,0,0,271,188,145,791,0,4,811,534,4,49,0,702,693,1395,1398
2014,6,94,9408,PAPUA,KEPULAUAN YAPEN,2055,1809,1591,218,0,31,40,73,83,80,68,50,36,111,161,0,0,227,148,86,272,0,20,672,56,0,5,0,345,388,733,733
2014,6,94,9412,PAPUA,MIMIKA,9011,9011,8976,35,0,43,27,293,240,202,217,154,129,1173,999,0,0,603,419,283,2172,0,30,1983,1330,74,88,0,1865,1612,3477,3475
2014,6,94,9410,PAPUA,PANIAI,122,122,122,0,0,10,7,26,20,5,5,1,3,12,135,0,0,63,10,4,147,0,0,116,5,0,1,0,54,170,224,122
2014,6,94,9415,PAPUA,ASMAT,1525,1525,1254,271,0,24,13,66,55,80,43,30,31,123,117,0,0,158,123,61,240,0,0,372,372,0,96,0,323,259,582,840
2014,6,94,9426,PAPUA,WAROPEN,578,578,578,0,0,7,16,30,22,27,21,13,16,81,80,0,0,75,48,29,161,0,0,300,13,0,0,0,158,155,313,313
2014,6,94,9402,PAPUA,JAYAWIJAYA,1889,1889,1811,78,0,3,3,1,10,2,6,3,3,58,40,0,0,17,8,6,98,0,0,56,71,0,2,0,67,62,129,129
2014,6,94,9411,PAPUA,PUNCAK JAYA,0,0,0,0,0,0,0,0,0,0,0,0,0,0,0,0,0,0,0,0,0,0,0,0,0,0,0,0,0,0,0,0
2014,6,94,9418,PAPUA,TOLIKARA,0,0,0,0,0,0,0,0,0,0,0,0,0,0,0,0,0,0,0,0,0,0,0,0,0,0,0,0,0,0,0,0
2014,6,94,9416,PAPUA,YAHUKIMO,0,0,0,0,0,0,0,0,0,0,0,0,0,0,0,0,0,0,0,0,0,0,0,0,0,0,0,0,0,0,0,0
2014,6,94,9417,PAPUA,PEGUNUNGAN BINTANG,0,0,0,0,0,0,0,0,0,0,0,0,0,0,0,0,0,0,0,0,0,0,0,0,0,0,0,0,0,0,0,0
2014,6,94,9428,PAPUA,MAMBERAMO RAYA,0,0,0,0,0,0,0,0,0,0,0,0,0,0,0,0,0,0,0,0,0,0,0,0,0,0,0,0,0,0,0,0
2014,6,94,9429,PAPUA,NDUGA,0,0,0,0,0,0,0,0,0,0,0,0,0,0,0,0,0,0,0,0,0,0,0,0,0,0,0,0,0,0,0,0
2014,6,94,9430,PAPUA,LANNY JAYA,0,0,0,0,0,0,0,0,0,0,0,0,0,0,0,0,0,0,0,0,0,0,0,0,0,0,0,0,0,0,0,0
2014,6,94,9431,PAPUA,MAMBERAMO TENGAH,0,0,0,0,0,0,0,0,0,0,0,0,0,0,0,0,0,0,0,0,0,0,0,0,0,0,0,0,0,0,0,0
2014,6,94,9432,PAPUA,YALIMO,0,0,0,0,0,0,0,0,0,0,0,0,0,0,0,0,0,0,0,0,0,0,0,0,0,0,0,0,0,0,0,0
2014,6,94,9433,PAPUA,PUNCAK,0,0,0,0,0,0,0,0,0,0,0,0,0,0,0,0,0,0,0,0,0,0,0,0,0,0,0,0,0,0,0,0
2014,6,94,9434,PAPUA,DOGIYAI,0,0,0,0,0,0,0,0,0,0,0,0,0,0,0,0,0,0,0,0,0,0,0,0,0,0,0,0,0,0,0,0
2014,6,94,9435,PAPUA,INTAN JAYA,0,0,0,0,0,0,0,0,0,0,0,0,0,0,0,0,0,0,0,0,0,0,0,0,0,0,0,0,0,0,0,0
2014,6,94,9436,PAPUA,DEIYAI,0,0,0,0,0,0,0,0,0,0,0,0,0,0,0,0,0,0,0,0,0,0,0,0,0,0,0,0,0,0,0,0
2014,7,91,9171,PAPUA BARAT,KOTA SORONG,1581,1581,1581,0,0,2,4,10,4,9,3,5,3,33,32,0,0,20,12,8,65,0,0,74,35,0,3,0,59,46,105,112
2014,7,91,9107,PAPUA BARAT,SORONG,998,979,727,252,0,1,0,4,11,3,3,6,0,9,8,0,0,16,6,6,17,0,0,20,16,0,9,0,23,22,45,45
2014,7,91,9106,PAPUA BARAT,SORONG SELATAN,1348,1348,1165,183,0,16,20,33,42,34,70,45,59,80,77,0,0,111,104,104,157,0,0,123,253,0,15,0,208,268,476,391
2014,7,91,9108,PAPUA BARAT,RAJA AMPAT,88,88,50,38,0,1,1,4,4,4,2,5,1,5,0,0,0,10,6,6,5,0,0,2,23,0,2,0,19,8,27,27
2014,7,91,9105,PAPUA BARAT,MANOKWARI,610,540,456,84,0,4,2,16,16,8,10,7,6,27,49,0,0,38,18,13,76,0,0,115,46,0,9,0,62,83,145,170
2014,7,91,9104,PAPUA BARAT,TELUK BINTUNI,113,113,43,70,0,0,0,4,6,0,1,1,0,3,2,0,0,10,1,1,5,0,0,6,10,0,1,0,8,9,17,17
2014,7,91,9103,PAPUA BARAT,TELUK WONDAMA,1109,1109,1084,25,0,38,26,108,129,81,116,117,92,153,157,0,0,301,197,209,310,0,36,120,127,0,7,0,497,520,1017,254
2014,7,91,9101,PAPUA BARAT,FAKFAK,1199,1199,1119,80,0,8,10,50,43,31,17,18,10,59,60,0,0,111,48,28,119,0,12,273,31,0,2,0,166,140,306,306
2014,7,91,9102,PAPUA BARAT,KAIMANA,920,679,532,147,0,1,1,2,5,3,1,0,1,14,6,0,0,9,4,1,20,0,0,22,9,0,3,0,20,14,34,34
2014,7,91,9109,PAPUA BARAT,TAMBRAUW,0,0,0,0,0,0,0,0,0,0,0,0,0,0,0,0,0,0,0,0,0,0,0,0,0,0,0,0,0,0,0,0
2014,7,91,9110,PAPUA BARAT,MAYBRAT,0,0,0,0,0,0,0,0,0,0,0,0,0,0,0,0,0,0,0,0,0,0,0,0,0,0,0,0,0,0,0,0
2014,7,94,9403,PAPUA,JAYAPURA,6526,6532,5459,1073,0,17,18,203,194,209,211,144,135,743,531,0,0,432,420,279,1274,0,0,1508,704,1,192,0,1316,1089,2405,2405
2014,7,94,9471,PAPUA,KOTA JAYAPURA,0,0,0,0,0,0,0,0,0,0,0,0,0,0,0,0,0,0,0,0,0,0,0,0,0,0,0,0,0,0,0,0
2014,7,94,9420,PAPUA,KEEROM,2754,2754,2215,539,0,8,4,62,62,86,82,66,50,350,277,0,0,136,168,116,627,0,3,621,372,6,48,0,572,475,1047,1047
2014,7,94,9419,PAPUA,SARMI,958,869,615,254,0,5,6,35,45,31,31,25,23,60,45,0,0,91,62,48,105,0,14,232,35,3,31,0,156,150,306,301
2014,7,94,9409,PAPUA,BIAK NUMFOR,1127,1127,1060,67,0,2,0,2,2,3,3,2,0,6,11,0,0,6,6,2,17,0,0,12,18,0,1,0,15,16,31,31
2014,7,94,9427,PAPUA,SUPIORI,301,301,291,10,0,4,5,25,13,13,1,3,5,32,19,0,0,47,14,8,51,0,0,49,74,0,0,0,77,43,120,123
2014,7,94,9401,PAPUA,MERAUKE,0,0,0,0,0,0,0,0,0,0,0,0,0,0,0,0,0,0,0,0,0,0,0,0,0,0,0,0,0,0,0,0
2014,7,94,9414,PAPUA,MAPPI,138,138,104,34,0,0,2,13,14,6,12,1,6,10,17,0,0,29,18,7,27,0,9,57,17,0,7,0,30,51,81,81
2014,7,94,9413,PAPUA,BOVEN DIGOEL,1346,1244,977,267,0,9,7,35,65,32,33,20,13,101,103,0,0,116,65,33,204,0,0,288,99,0,21,0,197,221,418,408
2014,7,94,9404,PAPUA,NABIRE,2539,2392,1837,555,0,1,2,19,20,28,25,25,38,96,95,0,0,42,53,63,191,0,2,158,175,0,16,0,169,180,349,349
2014,7,94,9408,PAPUA,KEPULAUAN YAPEN,1953,1499,1371,128,0,20,18,31,44,31,34,26,37,67,119,0,0,113,65,63,186,0,13,369,55,0,3,0,175,252,427,427
2014,7,94,9412,PAPUA,MIMIKA,7142,7142,7087,55,0,41,29,175,164,153,129,119,95,881,769,0,0,409,282,214,1650,0,22,1347,1101,50,33,0,1369,1186,2555,2531
2014,7,94,9410,PAPUA,PANIAI,439,66,66,0,0,10,7,11,0,2,3,0,0,12,11,0,0,28,5,0,23,0,0,59,1,0,0,0,35,21,56,60
2014,7,94,9415,PAPUA,ASMAT,0,0,0,0,0,0,0,0,0,0,0,0,0,0,0,0,0,0,0,0,0,0,0,0,0,0,0,0,0,0,0,0
2014,7,94,9426,PAPUA,WAROPEN,481,481,481,0,0,9,6,33,41,31,41,41,30,85,75,0,0,89,72,71,160,0,0,375,17,0,0,0,199,193,392,392
2014,7,94,9402,PAPUA,JAYAWIJAYA,1520,1520,1471,49,0,1,1,2,2,4,6,1,1,95,42,0,0,6,10,2,137,0,0,52,99,1,2,0,103,52,155,154
2014,7,94,9411,PAPUA,PUNCAK JAYA,0,0,0,0,0,0,0,0,0,0,0,0,0,0,0,0,0,0,0,0,0,0,0,0,0,0,0,0,0,0,0,0
2014,7,94,9418,PAPUA,TOLIKARA,0,0,0,0,0,0,0,0,0,0,0,0,0,0,0,0,0,0,0,0,0,0,0,0,0,0,0,0,0,0,0,0
2014,7,94,9416,PAPUA,YAHUKIMO,0,0,0,0,0,0,0,0,0,0,0,0,0,0,0,0,0,0,0,0,0,0,0,0,0,0,0,0,0,0,0,0
2014,7,94,9417,PAPUA,PEGUNUNGAN BINTANG,0,0,0,0,0,0,0,0,0,0,0,0,0,0,0,0,0,0,0,0,0,0,0,0,0,0,0,0,0,0,0,0
2014,7,94,9428,PAPUA,MAMBERAMO RAYA,0,0,0,0,0,0,0,0,0,0,0,0,0,0,0,0,0,0,0,0,0,0,0,0,0,0,0,0,0,0,0,0
2014,7,94,9429,PAPUA,NDUGA,0,0,0,0,0,0,0,0,0,0,0,0,0,0,0,0,0,0,0,0,0,0,0,0,0,0,0,0,0,0,0,0
2014,7,94,9430,PAPUA,LANNY JAYA,0,0,0,0,0,0,0,0,0,0,0,0,0,0,0,0,0,0,0,0,0,0,0,0,0,0,0,0,0,0,0,0
2014,7,94,9431,PAPUA,MAMBERAMO TENGAH,0,0,0,0,0,0,0,0,0,0,0,0,0,0,0,0,0,0,0,0,0,0,0,0,0,0,0,0,0,0,0,0
2014,7,94,9432,PAPUA,YALIMO,0,0,0,0,0,0,0,0,0,0,0,0,0,0,0,0,0,0,0,0,0,0,0,0,0,0,0,0,0,0,0,0
2014,7,94,9433,PAPUA,PUNCAK,0,0,0,0,0,0,0,0,0,0,0,0,0,0,0,0,0,0,0,0,0,0,0,0,0,0,0,0,0,0,0,0
2014,7,94,9434,PAPUA,DOGIYAI,0,0,0,0,0,0,0,0,0,0,0,0,0,0,0,0,0,0,0,0,0,0,0,0,0,0,0,0,0,0,0,0
2014,7,94,9435,PAPUA,INTAN JAYA,0,0,0,0,0,0,0,0,0,0,0,0,0,0,0,0,0,0,0,0,0,0,0,0,0,0,0,0,0,0,0,0
2014,7,94,9436,PAPUA,DEIYAI,0,0,0,0,0,0,0,0,0,0,0,0,0,0,0,0,0,0,0,0,0,0,0,0,0,0,0,0,0,0,0,0
2014,8,91,9171,PAPUA BARAT,KOTA SORONG,1707,1707,1707,0,0,2,1,3,5,11,7,3,5,31,29,0,0,11,18,8,60,0,0,53,38,0,6,0,50,47,97,97
2014,8,91,9107,PAPUA BARAT,SORONG,991,953,759,194,0,0,0,2,1,6,2,2,2,20,7,0,0,3,8,4,27,0,0,18,9,0,10,0,30,12,42,37
2014,8,91,9106,PAPUA BARAT,SORONG SELATAN,1141,1140,1080,60,0,12,16,35,40,30,45,33,34,68,64,0,0,103,75,67,132,0,30,107,258,0,12,0,178,199,377,377
2014,8,91,9108,PAPUA BARAT,RAJA AMPAT,0,85,0,85,0,0,1,5,7,6,6,9,4,12,3,0,0,13,12,13,15,0,1,13,0,0,5,0,32,21,53,18
2014,8,91,9105,PAPUA BARAT,MANOKWARI,1906,1821,1772,49,0,35,32,115,88,50,61,21,20,116,153,0,0,270,111,41,269,0,0,264,475,0,11,0,337,354,691,750
2014,8,91,9104,PAPUA BARAT,TELUK BINTUNI,220,220,112,108,0,0,0,0,2,1,2,3,0,14,0,0,0,2,3,3,14,0,0,9,11,0,2,0,18,4,22,22
2014,8,91,9103,PAPUA BARAT,TELUK WONDAMA,1217,1242,1217,25,0,20,17,92,92,60,59,31,41,88,130,0,0,221,119,72,218,0,36,193,109,0,7,0,291,339,630,309
2014,8,91,9101,PAPUA BARAT,FAKFAK,1206,1206,1110,96,0,14,7,52,36,28,21,14,8,42,44,0,0,109,49,22,86,0,26,247,17,0,2,0,150,116,266,266
2014,8,91,9102,PAPUA BARAT,KAIMANA,745,652,554,98,0,0,0,1,1,3,2,1,0,12,7,0,0,2,5,1,19,0,0,13,11,0,3,0,17,10,27,27
2014,8,91,9109,PAPUA BARAT,TAMBRAUW,0,0,0,0,0,0,0,0,0,0,0,0,0,0,0,0,0,0,0,0,0,0,0,0,0,0,0,0,0,0,0,0
2014,8,91,9110,PAPUA BARAT,MAYBRAT,0,0,0,0,0,0,0,0,0,0,0,0,0,0,0,0,0,0,0,0,0,0,0,0,0,0,0,0,0,0,0,0
2014,8,94,9403,PAPUA,JAYAPURA,4946,4939,3768,1171,0,15,33,150,148,150,156,122,121,377,355,0,0,346,306,243,732,0,0,1015,424,4,191,0,814,813,1627,1634
2014,8,94,9471,PAPUA,KOTA JAYAPURA,7192,7192,6045,1147,0,1,9,91,67,90,75,61,38,571,322,0,0,168,165,99,893,0,5,858,413,11,40,0,814,511,1325,1322
2014,8,94,9420,PAPUA,KEEROM,3223,3223,2589,634,0,3,4,78,68,110,99,71,82,319,273,0,0,153,209,153,592,0,2,719,339,0,49,0,581,526,1107,1107
2014,8,94,9419,PAPUA,SARMI,485,455,334,121,0,1,3,18,26,25,18,12,8,32,40,0,0,48,43,20,72,0,9,129,37,8,9,0,88,95,183,183
2014,8,94,9409,PAPUA,BIAK NUMFOR,387,387,363,24,0,0,0,1,1,0,0,0,0,1,0,0,0,2,0,0,1,0,0,2,2,0,0,0,2,1,3,4
2014,8,94,9427,PAPUA,SUPIORI,361,361,336,25,0,2,2,13,10,11,6,11,1,36,30,0,0,27,17,12,66,0,0,30,91,0,2,0,73,49,122,123
2014,8,94,9401,PAPUA,MERAUKE,723,425,300,125,0,9,5,14,11,11,9,0,3,37,32,0,0,39,20,3,69,0,1,3,127,0,1,0,71,60,131,131
2014,8,94,9414,PAPUA,MAPPI,330,288,269,19,0,2,0,15,9,6,7,5,6,14,8,0,0,26,13,11,22,0,5,48,21,0,3,0,42,30,72,72
2014,8,94,9413,PAPUA,BOVEN DIGOEL,1738,1648,1396,252,0,12,8,68,48,36,38,29,22,156,168,0,0,136,74,51,324,0,0,348,195,0,34,0,301,284,585,577
2014,8,94,9404,PAPUA,NABIRE,0,0,0,0,0,0,0,0,0,0,0,0,0,0,0,0,0,0,0,0,0,0,0,0,0,0,0,0,0,0,0,0
2014,8,94,9408,PAPUA,KEPULAUAN YAPEN,1271,1271,1271,0,0,28,33,35,44,28,32,31,37,75,134,0,0,140,60,68,209,0,21,432,43,0,2,0,197,280,477,477
2014,8,94,9412,PAPUA,MIMIKA,0,0,0,0,0,0,0,0,0,0,0,0,0,0,0,0,0,0,0,0,0,0,19,0,0,0,0,0,0,0,0,0
2014,8,94,9410,PAPUA,PANIAI,34,0,0,0,0,0,0,8,4,3,6,0,0,7,10,0,0,12,9,0,17,0,0,33,1,0,0,0,18,20,38,34
2014,8,94,9415,PAPUA,ASMAT,509,381,220,161,0,4,4,16,19,14,10,5,5,22,15,0,0,43,24,10,37,0,0,32,54,0,28,0,61,53,114,114
2014,8,94,9426,PAPUA,WAROPEN,450,450,450,0,0,6,14,25,28,38,29,42,41,83,79,0,0,73,67,83,162,0,0,361,26,0,0,0,194,191,385,387
2014,8,94,9402,PAPUA,JAYAWIJAYA,1675,1675,1555,120,0,0,1,5,5,4,6,1,4,59,18,0,0,11,10,5,77,0,0,39,55,0,5,0,69,34,103,99
2014,8,94,9411,PAPUA,PUNCAK JAYA,0,0,0,0,0,0,0,0,0,0,0,0,0,0,0,0,0,0,0,0,0,0,0,0,0,0,0,0,0,0,0,0
2014,8,94,9418,PAPUA,TOLIKARA,0,0,0,0,0,0,0,0,0,0,0,0,0,0,0,0,0,0,0,0,0,0,0,0,0,0,0,0,0,0,0,0
2014,8,94,9416,PAPUA,YAHUKIMO,0,0,0,0,0,0,0,0,0,0,0,0,0,0,0,0,0,0,0,0,0,0,0,0,0,0,0,0,0,0,0,0
2014,8,94,9417,PAPUA,PEGUNUNGAN BINTANG,0,0,0,0,0,0,0,0,0,0,0,0,0,0,0,0,0,0,0,0,0,0,0,0,0,0,0,0,0,0,0,0
2014,8,94,9428,PAPUA,MAMBERAMO RAYA,0,0,0,0,0,0,0,0,0,0,0,0,0,0,0,0,0,0,0,0,0,0,0,0,0,0,0,0,0,0,0,0
2014,8,94,9429,PAPUA,NDUGA,0,0,0,0,0,0,0,0,0,0,0,0,0,0,0,0,0,0,0,0,0,0,0,0,0,0,0,0,0,0,0,0
2014,8,94,9430,PAPUA,LANNY JAYA,0,0,0,0,0,0,0,0,0,0,0,0,0,0,0,0,0,0,0,0,0,0,0,0,0,0,0,0,0,0,0,0
2014,8,94,9431,PAPUA,MAMBERAMO TENGAH,0,0,0,0,0,0,0,0,0,0,0,0,0,0,0,0,0,0,0,0,0,0,0,0,0,0,0,0,0,0,0,0
2014,8,94,9432,PAPUA,YALIMO,0,0,0,0,0,0,0,0,0,0,0,0,0,0,0,0,0,0,0,0,0,0,0,0,0,0,0,0,0,0,0,0
2014,8,94,9433,PAPUA,PUNCAK,0,0,0,0,0,0,0,0,0,0,0,0,0,0,0,0,0,0,0,0,0,0,0,0,0,0,0,0,0,0,0,0
2014,8,94,9434,PAPUA,DOGIYAI,0,0,0,0,0,0,0,0,0,0,0,0,0,0,0,0,0,0,0,0,0,0,0,0,0,0,0,0,0,0,0,0
2014,8,94,9435,PAPUA,INTAN JAYA,0,0,0,0,0,0,0,0,0,0,0,0,0,0,0,0,0,0,0,0,0,0,0,0,0,0,0,0,0,0,0,0
2014,8,94,9436,PAPUA,DEIYAI,0,0,0,0,0,0,0,0,0,0,0,0,0,0,0,0,0,0,0,0,0,0,0,0,0,0,0,0,0,0,0,0
2014,9,91,9171,PAPUA BARAT,KOTA SORONG,1844,1844,1844,0,0,2,1,14,13,7,4,5,0,36,48,0,0,30,11,5,84,0,0,77,44,0,0,0,64,66,130,121
2014,9,91,9107,PAPUA BARAT,SORONG,1000,969,722,247,0,0,1,1,1,6,5,1,3,12,8,0,0,3,11,4,20,0,0,11,22,0,7,0,20,18,38,40
2014,9,91,9106,PAPUA BARAT,SORONG SELATAN,2039,2041,1750,291,0,15,26,45,59,44,56,37,58,83,90,0,0,145,100,95,173,0,0,120,332,0,16,0,224,289,513,468
2014,9,91,9108,PAPUA BARAT,RAJA AMPAT,89,89,71,18,0,0,0,4,1,1,3,0,8,10,4,0,0,5,4,8,14,0,0,14,15,0,2,0,15,16,31,31
2014,9,91,9105,PAPUA BARAT,MANOKWARI,2348,2216,2036,180,0,42,31,139,139,96,78,37,39,126,173,0,0,351,174,76,299,0,0,283,613,0,10,0,440,460,900,906
2014,9,91,9104,PAPUA BARAT,TELUK BINTUNI,59,59,31,28,0,1,1,0,1,1,0,1,0,1,2,0,0,3,1,1,3,0,0,0,5,0,3,0,4,4,8,8
2014,9,91,9103,PAPUA BARAT,TELUK WONDAMA,916,916,916,0,0,22,107,79,117,121,125,101,78,122,106,0,0,325,246,179,228,0,15,133,122,0,4,0,445,533,978,259
2014,9,91,9101,PAPUA BARAT,FAKFAK,1726,1726,1665,61,0,16,25,105,101,56,59,17,19,58,81,0,0,247,115,36,139,0,0,529,7,0,0,0,252,285,537,536
2014,9,91,9102,PAPUA BARAT,KAIMANA,544,511,459,52,0,0,0,0,0,1,2,1,0,7,2,0,0,0,3,1,9,0,0,3,10,0,0,0,9,4,13,13
2014,9,91,9109,PAPUA BARAT,TAMBRAUW,0,0,0,0,0,0,0,0,0,0,0,0,0,0,0,0,0,0,0,0,0,0,0,0,0,0,0,0,0,0,0,0
2014,9,91,9110,PAPUA BARAT,MAYBRAT,0,0,0,0,0,0,0,0,0,0,0,0,0,0,0,0,0,0,0,0,0,0,0,0,0,0,0,0,0,0,0,0
2014,9,94,9403,PAPUA,JAYAPURA,2309,2309,1773,536,0,17,13,102,94,120,95,62,48,194,190,0,0,226,215,110,384,0,0,580,234,7,114,0,495,440,935,935
2014,9,94,9471,PAPUA,KOTA JAYAPURA,6310,6918,6276,642,0,1,7,68,66,82,83,63,49,428,289,0,0,142,165,112,717,0,9,683,416,1,40,0,642,494,1136,1140
2014,9,94,9420,PAPUA,KEEROM,1193,1193,941,252,0,3,2,33,37,38,48,38,27,120,89,0,0,75,86,65,209,0,0,262,145,2,19,0,232,203,435,428
2014,9,94,9419,PAPUA,SARMI,0,0,0,0,0,0,0,0,0,0,0,0,0,0,0,0,0,0,0,0,0,0,0,0,0,0,0,0,0,0,0,0
2014,9,94,9409,PAPUA,BIAK NUMFOR,1170,1164,1097,67,0,1,0,5,7,5,5,3,4,12,28,0,0,13,10,7,40,0,0,15,42,0,12,0,26,44,70,69
2014,9,94,9427,PAPUA,SUPIORI,12035,9441,9402,39,0,6,6,51,32,35,34,17,15,96,120,0,0,95,69,32,216,0,0,142,255,0,16,0,205,207,412,413
2014,9,94,9401,PAPUA,MERAUKE,470,470,446,24,0,2,1,12,11,7,7,5,4,28,22,0,0,26,14,9,50,0,0,67,32,0,0,0,54,45,99,99
2014,9,94,9414,PAPUA,MAPPI,400,400,326,74,0,6,0,12,11,8,9,9,7,13,25,0,0,29,17,16,38,0,0,66,25,0,5,0,48,52,100,96
2014,9,94,9413,PAPUA,BOVEN DIGOEL,1416,1416,1068,348,0,9,6,55,45,35,45,26,12,91,113,0,0,115,80,38,204,0,0,287,147,0,16,0,216,221,437,450
2014,9,94,9404,PAPUA,NABIRE,4687,4687,3903,784,0,17,18,34,52,51,43,57,62,236,221,0,0,121,94,119,457,0,1,323,443,0,25,0,395,396,791,791
2014,9,94,9408,PAPUA,KEPULAUAN YAPEN,1795,1795,1586,209,0,30,33,66,61,102,86,82,86,111,142,0,0,190,188,168,253,0,24,741,55,0,3,0,391,408,799,799
2014,9,94,9412,PAPUA,MIMIKA,6126,6100,6090,10,0,19,17,137,134,94,92,84,69,559,447,0,0,307,186,153,1006,0,0,734,789,55,61,0,893,759,1652,1639
2014,9,94,9410,PAPUA,PANIAI,107,91,91,0,0,5,4,18,13,4,2,0,0,16,22,0,0,40,6,0,38,0,0,68,2,0,0,0,43,41,84,70
2014,9,94,9415,PAPUA,ASMAT,177,126,56,70,0,13,11,8,2,6,86,50,2,4,5,0,0,34,92,52,9,0,0,98,34,0,55,0,81,106,187,187
2014,9,94,9426,PAPUA,WAROPEN,540,540,540,0,0,9,17,32,30,40,44,46,27,71,53,0,0,88,84,73,124,0,0,366,21,0,0,0,198,171,369,387
2014,9,94,9402,PAPUA,JAYAWIJAYA,933,933,883,50,0,0,0,0,1,4,4,0,1,41,28,0,0,1,8,1,69,0,0,34,43,0,2,0,45,34,79,79
2014,9,94,9411,PAPUA,PUNCAK JAYA,0,0,0,0,0,0,0,0,0,0,0,0,0,0,0,0,0,0,0,0,0,0,0,0,0,0,0,0,0,0,0,0
2014,9,94,9418,PAPUA,TOLIKARA,0,0,0,0,0,0,0,0,0,0,0,0,0,0,0,0,0,0,0,0,0,0,0,0,0,0,0,0,0,0,0,0
2014,9,94,9416,PAPUA,YAHUKIMO,0,0,0,0,0,0,0,0,0,0,0,0,0,0,0,0,0,0,0,0,0,0,0,0,0,0,0,0,0,0,0,0
2014,9,94,9417,PAPUA,PEGUNUNGAN BINTANG,0,0,0,0,0,0,0,0,0,0,0,0,0,0,0,0,0,0,0,0,0,0,0,0,0,0,0,0,0,0,0,0
2014,9,94,9428,PAPUA,MAMBERAMO RAYA,0,0,0,0,0,0,0,0,0,0,0,0,0,0,0,0,0,0,0,0,0,0,0,0,0,0,0,0,0,0,0,0
2014,9,94,9429,PAPUA,NDUGA,0,0,0,0,0,0,0,0,0,0,0,0,0,0,0,0,0,0,0,0,0,0,0,0,0,0,0,0,0,0,0,0
2014,9,94,9430,PAPUA,LANNY JAYA,0,0,0,0,0,0,0,0,0,0,0,0,0,0,0,0,0,0,0,0,0,0,0,0,0,0,0,0,0,0,0,0
2014,9,94,9431,PAPUA,MAMBERAMO TENGAH,0,0,0,0,0,0,0,0,0,0,0,0,0,0,0,0,0,0,0,0,0,0,0,0,0,0,0,0,0,0,0,0
2014,9,94,9432,PAPUA,YALIMO,0,0,0,0,0,0,0,0,0,0,0,0,0,0,0,0,0,0,0,0,0,0,0,0,0,0,0,0,0,0,0,0
2014,9,94,9433,PAPUA,PUNCAK,0,0,0,0,0,0,0,0,0,0,0,0,0,0,0,0,0,0,0,0,0,0,0,0,0,0,0,0,0,0,0,0
2014,9,94,9434,PAPUA,DOGIYAI,0,0,0,0,0,0,0,0,0,0,0,0,0,0,0,0,0,0,0,0,0,0,0,0,0,0,0,0,0,0,0,0
2014,9,94,9435,PAPUA,INTAN JAYA,0,0,0,0,0,0,0,0,0,0,0,0,0,0,0,0,0,0,0,0,0,0,0,0,0,0,0,0,0,0,0,0
2014,9,94,9436,PAPUA,DEIYAI,0,0,0,0,0,0,0,0,0,0,0,0,0,0,0,0,0,0,0,0,0,0,0,0,0,0,0,0,0,0,0,0
2014,10,91,9171,PAPUA BARAT,KOTA SORONG,251,251,251,0,0,0,1,0,0,0,0,0,0,7,7,0,0,1,0,0,14,0,0,11,4,0,0,0,7,8,15,15
2014,10,91,9107,PAPUA BARAT,SORONG,855,855,635,220,0,1,0,4,5,5,1,1,0,10,3,0,0,10,6,1,13,0,0,15,8,0,5,0,21,9,30,28
2014,10,91,9106,PAPUA BARAT,SORONG SELATAN,359,370,328,42,0,10,5,9,10,7,5,3,18,14,3,0,0,34,12,21,17,0,0,4,0,0,0,0,43,41,84,4
2014,10,91,9108,PAPUA BARAT,RAJA AMPAT,54,54,32,22,0,0,0,0,1,0,3,1,0,4,8,0,0,1,3,1,12,0,0,4,13,0,0,0,5,12,17,17
2014,10,91,9105,PAPUA BARAT,MANOKWARI,1041,942,926,16,0,7,11,36,38,16,7,10,6,38,32,0,0,92,23,16,70,0,0,226,204,0,13,0,107,94,201,443
2014,10,91,9104,PAPUA BARAT,TELUK BINTUNI,101,101,41,60,0,1,0,0,0,1,1,1,0,4,2,0,0,1,2,1,6,0,0,1,4,0,5,0,7,3,10,10
2014,10,91,9103,PAPUA BARAT,TELUK WONDAMA,1196,1196,1196,0,0,19,23,74,47,46,28,16,24,54,63,0,0,163,74,40,117,0,42,225,91,0,13,0,209,185,394,329
2014,10,91,9101,PAPUA BARAT,FAKFAK,424,424,402,22,0,0,1,10,3,7,2,3,2,5,2,0,0,14,9,5,7,0,0,31,4,0,0,0,25,10,35,35
2014,10,91,9102,PAPUA BARAT,KAIMANA,382,375,190,185,0,1,1,1,2,3,4,3,4,17,11,0,0,5,7,7,28,0,1,6,36,0,5,0,25,22,47,47
2014,10,91,9109,PAPUA BARAT,TAMBRAUW,0,0,0,0,0,0,0,0,0,0,0,0,0,0,0,0,0,0,0,0,0,0,0,0,0,0,0,0,0,0,0,0
2014,10,91,9110,PAPUA BARAT,MAYBRAT,0,0,0,0,0,0,0,0,0,0,0,0,0,0,0,0,0,0,0,0,0,0,0,0,0,0,0,0,0,0,0,0
2014,10,94,9403,PAPUA,JAYAPURA,3712,3704,3093,611,0,17,22,103,97,101,89,69,41,215,225,0,0,239,190,110,440,0,0,728,302,1,125,0,505,474,979,1156
2014,10,94,9471,PAPUA,KOTA JAYAPURA,6223,6223,5375,848,0,4,11,75,88,75,89,89,69,521,352,0,0,178,164,158,873,0,0,668,600,37,71,0,764,609,1373,1376
2014,10,94,9420,PAPUA,KEEROM,0,0,0,0,0,0,0,0,0,0,0,0,0,0,0,0,0,0,0,0,0,0,0,0,0,0,0,0,0,0,0,0
2014,10,94,9419,PAPUA,SARMI,0,0,0,0,0,0,0,0,0,0,0,0,0,0,0,0,0,0,0,0,0,0,0,0,0,0,0,0,0,0,0,0
2014,10,94,9409,PAPUA,BIAK NUMFOR,438,426,416,10,0,0,0,0,0,0,0,0,0,0,2,0,0,0,0,0,2,0,0,2,0,0,1,0,0,2,2,3
2014,10,94,9427,PAPUA,SUPIORI,673,647,537,110,0,18,8,29,24,20,8,11,7,44,58,0,0,79,28,18,102,0,0,92,134,0,1,0,122,105,227,227
2014,10,94,9401,PAPUA,MERAUKE,0,0,0,0,0,0,0,0,0,0,0,0,0,0,0,0,0,0,0,0,0,0,0,0,0,0,0,0,0,0,0,0
2014,10,94,9414,PAPUA,MAPPI,274,108,87,21,0,1,3,6,10,1,1,2,2,2,21,0,0,20,2,4,23,0,0,48,19,0,3,0,12,37,49,70
2014,10,94,9413,PAPUA,BOVEN DIGOEL,942,942,781,161,0,2,4,34,38,34,22,19,13,80,131,0,0,78,56,32,211,0,0,235,114,0,28,0,169,208,377,377
2014,10,94,9404,PAPUA,NABIRE,3746,3746,2179,1567,0,33,18,49,51,50,45,58,62,244,233,0,0,151,95,120,477,0,0,347,464,0,20,0,434,409,843,831
2014,10,94,9408,PAPUA,KEPULAUAN YAPEN,1142,1131,1131,0,0,18,16,19,72,45,72,74,81,86,99,0,0,125,117,155,185,0,0,534,10,0,0,0,242,340,582,544
2014,10,94,9412,PAPUA,MIMIKA,0,0,0,0,0,0,0,0,0,0,0,0,0,0,0,0,0,0,0,0,0,0,0,0,0,0,0,0,0,0,0,0
2014,10,94,9410,PAPUA,PANIAI,77,77,77,0,0,4,3,15,13,1,3,2,2,8,11,0,0,35,4,4,19,0,0,69,0,0,0,0,30,32,62,69
2014,10,94,9415,PAPUA,ASMAT,0,0,0,0,0,0,0,0,0,0,0,0,0,0,0,0,0,0,0,0,0,0,0,0,0,0,0,0,0,0,0,0
2014,10,94,9426,PAPUA,WAROPEN,510,510,510,0,0,7,4,28,24,22,16,7,19,53,106,0,0,63,38,26,159,0,0,275,5,0,0,0,117,169,286,280
2014,10,94,9402,PAPUA,JAYAWIJAYA,1211,1211,858,353,0,0,1,8,5,2,3,4,1,44,32,0,0,14,5,5,76,0,0,46,54,0,0,0,58,42,100,100
2014,10,94,9411,PAPUA,PUNCAK JAYA,0,0,0,0,0,0,0,0,0,0,0,0,0,0,0,0,0,0,0,0,0,0,0,0,0,0,0,0,0,0,0,0
2014,10,94,9418,PAPUA,TOLIKARA,0,0,0,0,0,0,0,0,0,0,0,0,0,0,0,0,0,0,0,0,0,0,0,0,0,0,0,0,0,0,0,0
2014,10,94,9416,PAPUA,YAHUKIMO,0,0,0,0,0,0,0,0,0,0,0,0,0,0,0,0,0,0,0,0,0,0,0,0,0,0,0,0,0,0,0,0
2014,10,94,9417,PAPUA,PEGUNUNGAN BINTANG,0,0,0,0,0,0,0,0,0,0,0,0,0,0,0,0,0,0,0,0,0,0,0,0,0,0,0,0,0,0,0,0
2014,10,94,9428,PAPUA,MAMBERAMO RAYA,0,0,0,0,0,0,0,0,0,0,0,0,0,0,0,0,0,0,0,0,0,0,0,0,0,0,0,0,0,0,0,0
2014,10,94,9429,PAPUA,NDUGA,0,0,0,0,0,0,0,0,0,0,0,0,0,0,0,0,0,0,0,0,0,0,0,0,0,0,0,0,0,0,0,0
2014,10,94,9430,PAPUA,LANNY JAYA,0,0,0,0,0,0,0,0,0,0,0,0,0,0,0,0,0,0,0,0,0,0,0,0,0,0,0,0,0,0,0,0
2014,10,94,9431,PAPUA,MAMBERAMO TENGAH,0,0,0,0,0,0,0,0,0,0,0,0,0,0,0,0,0,0,0,0,0,0,0,0,0,0,0,0,0,0,0,0
2014,10,94,9432,PAPUA,YALIMO,0,0,0,0,0,0,0,0,0,0,0,0,0,0,0,0,0,0,0,0,0,0,0,0,0,0,0,0,0,0,0,0
2014,10,94,9433,PAPUA,PUNCAK,0,0,0,0,0,0,0,0,0,0,0,0,0,0,0,0,0,0,0,0,0,0,0,0,0,0,0,0,0,0,0,0
2014,10,94,9434,PAPUA,DOGIYAI,0,0,0,0,0,0,0,0,0,0,0,0,0,0,0,0,0,0,0,0,0,0,0,0,0,0,0,0,0,0,0,0
2014,10,94,9435,PAPUA,INTAN JAYA,0,0,0,0,0,0,0,0,0,0,0,0,0,0,0,0,0,0,0,0,0,0,0,0,0,0,0,0,0,0,0,0
2014,10,94,9436,PAPUA,DEIYAI,0,0,0,0,0,0,0,0,0,0,0,0,0,0,0,0,0,0,0,0,0,0,0,0,0,0,0,0,0,0,0,0
2014,11,91,9171,PAPUA BARAT,KOTA SORONG,2117,2107,2107,0,0,9,7,27,30,14,16,15,39,27,26,0,0,73,30,54,53,0,0,72,137,0,1,0,92,118,210,210
2014,11,91,9107,PAPUA BARAT,SORONG,862,844,707,137,0,0,0,1,3,2,0,0,0,8,4,0,0,4,2,0,12,0,0,11,6,0,1,0,11,7,18,18
2014,11,91,9106,PAPUA BARAT,SORONG SELATAN,153,153,147,6,0,3,7,0,0,0,1,0,0,0,0,0,0,10,1,0,0,0,0,2,8,0,1,0,3,8,11,11
2014,11,91,9108,PAPUA BARAT,RAJA AMPAT,60,57,0,57,0,0,1,4,8,4,8,7,6,13,9,0,0,13,12,13,22,0,0,16,1,0,6,0,28,32,60,23
2014,11,91,9105,PAPUA BARAT,MANOKWARI,914,722,702,20,0,3,3,11,16,13,6,9,10,48,48,0,0,33,19,19,96,0,0,71,85,0,10,0,84,83,167,166
2014,11,91,9104,PAPUA BARAT,TELUK BINTUNI,180,180,146,34,0,0,0,0,0,1,0,1,0,2,1,0,0,0,1,1,3,0,0,2,3,0,0,0,4,1,5,5
2014,11,91,9103,PAPUA BARAT,TELUK WONDAMA,143,143,115,28,0,3,1,1,12,2,4,3,7,13,21,0,0,17,6,10,34,0,0,11,53,0,3,0,22,45,67,67
2014,11,91,9101,PAPUA BARAT,FAKFAK,1475,1475,1318,157,0,13,15,61,39,30,17,13,14,54,37,0,0,128,47,27,91,0,37,290,3,0,0,0,171,122,293,293
2014,11,91,9102,PAPUA BARAT,KAIMANA,374,252,238,14,0,0,1,3,1,2,2,2,1,8,3,0,0,5,4,3,11,0,0,5,12,0,6,0,15,8,23,23
2014,11,91,9109,PAPUA BARAT,TAMBRAUW,0,0,0,0,0,0,0,0,0,0,0,0,0,0,0,0,0,0,0,0,0,0,0,0,0,0,0,0,0,0,0,0
2014,11,91,9110,PAPUA BARAT,MAYBRAT,0,0,0,0,0,0,0,0,0,0,0,0,0,0,0,0,0,0,0,0,0,0,0,0,0,0,0,0,0,0,0,0
2014,11,94,9403,PAPUA,JAYAPURA,5803,5803,5090,713,0,19,27,164,138,192,135,119,108,550,487,0,0,348,327,227,1037,0,0,1266,597,4,72,0,1044,895,1939,1939
2014,11,94,9471,PAPUA,KOTA JAYAPURA,0,0,0,0,0,0,0,0,0,0,0,0,0,0,0,0,0,0,0,0,0,0,0,0,0,0,0,0,0,0,0,0
2014,11,94,9420,PAPUA,KEEROM,0,0,0,0,0,0,0,0,0,0,0,0,0,0,0,0,0,0,0,0,0,0,0,0,0,0,0,0,0,0,0,0
2014,11,94,9419,PAPUA,SARMI,0,0,0,0,0,0,0,0,0,0,0,0,0,0,0,0,0,0,0,0,0,0,0,0,0,0,0,0,0,0,0,0
2014,11,94,9409,PAPUA,BIAK NUMFOR,1106,971,971,0,0,6,1,20,24,14,13,6,9,23,62,0,0,51,27,15,85,0,0,20,155,0,3,0,69,109,178,178
2014,11,94,9427,PAPUA,SUPIORI,0,0,0,0,0,0,0,0,0,0,0,0,0,0,0,0,0,0,0,0,0,0,0,0,0,0,0,0,0,0,0,0
2014,11,94,9401,PAPUA,MERAUKE,0,0,0,0,0,0,0,0,0,0,0,0,0,0,0,0,0,0,0,0,0,0,0,0,0,0,0,0,0,0,0,0
2014,11,94,9414,PAPUA,MAPPI,177,177,115,62,0,2,2,9,11,5,3,3,0,12,21,0,0,24,8,3,33,0,7,54,12,0,2,0,31,37,68,68
2014,11,94,9413,PAPUA,BOVEN DIGOEL,806,806,706,100,0,9,10,32,31,21,24,8,13,70,100,0,0,82,45,21,170,0,4,205,100,0,13,0,140,178,318,318
2014,11,94,9404,PAPUA,NABIRE,4571,4571,4034,537,0,12,12,57,53,43,39,54,55,211,247,0,0,134,82,109,458,0,2,387,364,0,32,0,377,406,783,783
2014,11,94,9408,PAPUA,KEPULAUAN YAPEN,0,0,0,0,0,0,0,0,0,0,0,0,0,0,0,0,0,0,0,0,0,0,0,0,0,0,0,0,0,0,0,0
2014,11,94,9412,PAPUA,MIMIKA,0,0,0,0,0,0,0,0,0,0,0,0,0,0,0,0,0,0,0,0,0,0,0,0,0,0,0,0,0,0,0,0
2014,11,94,9410,PAPUA,PANIAI,286,127,127,0,0,4,5,22,20,9,8,3,2,24,32,0,0,51,17,5,56,0,0,124,3,0,20,0,62,67,129,147
2014,11,94,9415,PAPUA,ASMAT,0,0,0,0,0,0,0,0,0,0,0,0,0,0,0,0,0,0,0,0,0,0,0,0,0,0,0,0,0,0,0,0
2014,11,94,9426,PAPUA,WAROPEN,603,603,603,0,0,22,5,54,37,40,29,10,10,98,143,0,0,118,69,20,241,0,3,279,4,0,0,0,224,224,448,283
2014,11,94,9402,PAPUA,JAYAWIJAYA,794,794,794,0,0,0,0,3,3,3,0,4,0,27,18,0,0,6,3,4,45,0,0,17,40,0,0,0,37,21,58,57
2014,11,94,9411,PAPUA,PUNCAK JAYA,0,0,0,0,0,0,0,0,0,0,0,0,0,0,0,0,0,0,0,0,0,0,0,0,0,0,0,0,0,0,0,0
2014,11,94,9418,PAPUA,TOLIKARA,0,0,0,0,0,0,0,0,0,0,0,0,0,0,0,0,0,0,0,0,0,0,0,0,0,0,0,0,0,0,0,0
2014,11,94,9416,PAPUA,YAHUKIMO,0,0,0,0,0,0,0,0,0,0,0,0,0,0,0,0,0,0,0,0,0,0,0,0,0,0,0,0,0,0,0,0
2014,11,94,9417,PAPUA,PEGUNUNGAN BINTANG,0,0,0,0,0,0,0,0,0,0,0,0,0,0,0,0,0,0,0,0,0,0,0,0,0,0,0,0,0,0,0,0
2014,11,94,9428,PAPUA,MAMBERAMO RAYA,0,0,0,0,0,0,0,0,0,0,0,0,0,0,0,0,0,0,0,0,0,0,0,0,0,0,0,0,0,0,0,0
2014,11,94,9429,PAPUA,NDUGA,0,0,0,0,0,0,0,0,0,0,0,0,0,0,0,0,0,0,0,0,0,0,0,0,0,0,0,0,0,0,0,0
2014,11,94,9430,PAPUA,LANNY JAYA,0,0,0,0,0,0,0,0,0,0,0,0,0,0,0,0,0,0,0,0,0,0,0,0,0,0,0,0,0,0,0,0
2014,11,94,9431,PAPUA,MAMBERAMO TENGAH,0,0,0,0,0,0,0,0,0,0,0,0,0,0,0,0,0,0,0,0,0,0,0,0,0,0,0,0,0,0,0,0
2014,11,94,9432,PAPUA,YALIMO,0,0,0,0,0,0,0,0,0,0,0,0,0,0,0,0,0,0,0,0,0,0,0,0,0,0,0,0,0,0,0,0
2014,11,94,9433,PAPUA,PUNCAK,0,0,0,0,0,0,0,0,0,0,0,0,0,0,0,0,0,0,0,0,0,0,0,0,0,0,0,0,0,0,0,0
2014,11,94,9434,PAPUA,DOGIYAI,0,0,0,0,0,0,0,0,0,0,0,0,0,0,0,0,0,0,0,0,0,0,0,0,0,0,0,0,0,0,0,0
2014,11,94,9435,PAPUA,INTAN JAYA,0,0,0,0,0,0,0,0,0,0,0,0,0,0,0,0,0,0,0,0,0,0,0,0,0,0,0,0,0,0,0,0
2014,11,94,9436,PAPUA,DEIYAI,0,0,0,0,0,0,0,0,0,0,0,0,0,0,0,0,0,0,0,0,0,0,0,0,0,0,0,0,0,0,0,0
2014,12,91,9171,PAPUA BARAT,KOTA SORONG,1448,1431,1431,0,0,6,4,22,16,16,13,13,11,16,16,0,0,48,29,24,32,0,0,30,103,0,0,0,73,60,133,133
2014,12,91,9107,PAPUA BARAT,SORONG,561,550,449,101,0,0,0,1,3,3,1,2,1,8,4,0,0,4,4,3,12,0,0,13,8,0,2,0,14,9,23,23
2014,12,91,9106,PAPUA BARAT,SORONG SELATAN,1020,1020,1000,20,0,10,13,43,50,52,69,43,45,65,55,0,0,116,121,88,120,0,0,129,140,0,0,0,213,232,445,269
2014,12,91,9108,PAPUA BARAT,RAJA AMPAT,6,17,0,17,0,0,0,1,0,4,3,1,0,4,0,0,0,1,7,1,4,0,0,2,2,0,2,0,10,3,13,6
2014,12,91,9105,PAPUA BARAT,MANOKWARI,610,540,456,84,0,4,2,16,16,8,10,7,6,27,49,0,0,38,18,13,76,0,0,115,46,0,0,0,62,83,145,161
2014,12,91,9104,PAPUA BARAT,TELUK BINTUNI,970,970,666,304,0,1,0,2,0,0,0,0,0,5,1,0,0,3,0,0,6,0,0,2,7,0,0,0,8,1,9,9
2014,12,91,9103,PAPUA BARAT,TELUK WONDAMA,1202,1202,727,475,0,22,107,79,117,121,125,101,78,122,106,0,0,325,246,179,228,0,1,110,120,0,4,0,445,533,978,234
2014,12,91,9101,PAPUA BARAT,FAKFAK,665,665,559,106,0,9,10,47,39,24,24,5,6,24,32,0,0,105,48,11,56,0,0,219,1,0,0,0,109,111,220,220
2014,12,91,9102,PAPUA BARAT,KAIMANA,259,226,217,9,0,0,0,0,0,1,0,0,3,2,5,0,0,0,1,3,7,0,0,7,4,0,0,0,3,8,11,11
2014,12,91,9109,PAPUA BARAT,TAMBRAUW,0,0,0,0,0,0,0,0,0,0,0,0,0,0,0,0,0,0,0,0,0,0,0,0,0,0,0,0,0,0,0,0
2014,12,91,9110,PAPUA BARAT,MAYBRAT,0,0,0,0,0,0,0,0,0,0,0,0,0,0,0,0,0,0,0,0,0,0,0,0,0,0,0,0,0,0,0,0
2014,12,94,9403,PAPUA,JAYAPURA,2246,2246,2120,126,0,17,14,80,71,74,76,60,59,233,240,0,0,182,150,119,473,0,0,620,272,1,30,0,464,460,924,923
2014,12,94,9471,PAPUA,KOTA JAYAPURA,0,0,0,0,0,0,0,0,0,0,0,0,0,0,0,0,0,0,0,0,0,0,0,0,0,0,0,0,0,0,0,0
2014,12,94,9420,PAPUA,KEEROM,0,0,0,0,0,0,0,0,0,0,0,0,0,0,0,0,0,0,0,0,0,0,0,0,0,0,0,0,0,0,0,0
2014,12,94,9419,PAPUA,SARMI,0,0,0,0,0,0,0,0,0,0,0,0,0,0,0,0,0,0,0,0,0,0,0,0,0,0,0,0,0,0,0,0
2014,12,94,9409,PAPUA,BIAK NUMFOR,0,0,0,0,0,0,0,0,0,0,0,0,0,0,0,0,0,0,0,0,0,0,0,0,0,0,0,0,0,0,0,0
2014,12,94,9427,PAPUA,SUPIORI,0,0,0,0,0,0,0,0,0,0,0,0,0,0,0,0,0,0,0,0,0,0,0,0,0,0,0,0,0,0,0,0
2014,12,94,9401,PAPUA,MERAUKE,0,0,0,0,0,0,0,0,0,0,0,0,0,0,0,0,0,0,0,0,0,0,0,0,0,0,0,0,0,0,0,0
2014,12,94,9414,PAPUA,MAPPI,89,89,38,51,0,4,2,5,2,2,2,0,2,2,5,0,0,13,4,2,7,0,0,12,7,0,5,0,13,13,26,24
2014,12,94,9413,PAPUA,BOVEN DIGOEL,678,678,562,116,0,10,9,10,33,22,14,6,5,38,62,0,0,62,36,11,100,0,0,132,100,0,14,0,86,123,209,246
2014,12,94,9404,PAPUA,NABIRE,0,0,0,0,0,0,0,0,0,0,0,0,0,0,0,0,0,0,0,0,0,0,0,0,0,0,0,0,0,0,0,0
2014,12,94,9408,PAPUA,KEPULAUAN YAPEN,0,0,0,0,0,0,0,0,0,0,0,0,0,0,0,0,0,0,0,0,0,0,0,0,0,0,0,0,0,0,0,0
2014,12,94,9412,PAPUA,MIMIKA,0,0,0,0,0,0,0,0,0,0,0,0,0,0,0,0,0,0,0,0,0,0,0,0,0,0,0,0,0,0,0,0
2014,12,94,9410,PAPUA,PANIAI,0,0,0,0,0,0,0,0,0,0,0,0,0,0,0,0,0,0,0,0,0,0,0,0,0,0,0,0,0,0,0,0
2014,12,94,9415,PAPUA,ASMAT,0,0,0,0,0,0,0,0,0,0,0,0,0,0,0,0,0,0,0,0,0,0,0,0,0,0,0,0,0,0,0,0
2014,12,94,9426,PAPUA,WAROPEN,0,0,0,0,0,0,0,0,0,0,0,0,0,0,0,0,0,0,0,0,0,0,0,0,0,0,0,0,0,0,0,0
2014,12,94,9402,PAPUA,JAYAWIJAYA,0,246,246,0,0,0,0,3,2,3,0,3,0,7,9,0,0,5,3,3,16,0,0,2,17,0,0,0,16,11,27,19
2014,12,94,9411,PAPUA,PUNCAK JAYA,0,0,0,0,0,0,0,0,0,0,0,0,0,0,0,0,0,0,0,0,0,0,0,0,0,0,0,0,0,0,0,0
2014,12,94,9418,PAPUA,TOLIKARA,0,0,0,0,0,0,0,0,0,0,0,0,0,0,0,0,0,0,0,0,0,0,0,0,0,0,0,0,0,0,0,0
2014,12,94,9416,PAPUA,YAHUKIMO,0,0,0,0,0,0,0,0,0,0,0,0,0,0,0,0,0,0,0,0,0,0,0,0,0,0,0,0,0,0,0,0
2014,12,94,9417,PAPUA,PEGUNUNGAN BINTANG,0,0,0,0,0,0,0,0,0,0,0,0,0,0,0,0,0,0,0,0,0,0,0,0,0,0,0,0,0,0,0,0
2014,12,94,9428,PAPUA,MAMBERAMO RAYA,0,0,0,0,0,0,0,0,0,0,0,0,0,0,0,0,0,0,0,0,0,0,0,0,0,0,0,0,0,0,0,0
2014,12,94,9429,PAPUA,NDUGA,0,0,0,0,0,0,0,0,0,0,0,0,0,0,0,0,0,0,0,0,0,0,0,0,0,0,0,0,0,0,0,0
2014,12,94,9430,PAPUA,LANNY JAYA,0,0,0,0,0,0,0,0,0,0,0,0,0,0,0,0,0,0,0,0,0,0,0,0,0,0,0,0,0,0,0,0
2014,12,94,9431,PAPUA,MAMBERAMO TENGAH,0,0,0,0,0,0,0,0,0,0,0,0,0,0,0,0,0,0,0,0,0,0,0,0,0,0,0,0,0,0,0,0
2014,12,94,9432,PAPUA,YALIMO,0,0,0,0,0,0,0,0,0,0,0,0,0,0,0,0,0,0,0,0,0,0,0,0,0,0,0,0,0,0,0,0
2014,12,94,9433,PAPUA,PUNCAK,0,0,0,0,0,0,0,0,0,0,0,0,0,0,0,0,0,0,0,0,0,0,0,0,0,0,0,0,0,0,0,0
2014,12,94,9434,PAPUA,DOGIYAI,0,0,0,0,0,0,0,0,0,0,0,0,0,0,0,0,0,0,0,0,0,0,0,0,0,0,0,0,0,0,0,0
2014,12,94,9435,PAPUA,INTAN JAYA,0,0,0,0,0,0,0,0,0,0,0,0,0,0,0,0,0,0,0,0,0,0,0,0,0,0,0,0,0,0,0,0
2014,12,94,9436,PAPUA,DEIYAI,0,0,0,0,0,0,0,0,0,0,0,0,0,0,0,0,0,0,0,0,0,0,0,0,0,0,0,0,0,0,0,0
2015,1,91,9171,PAPUA BARAT,KOTA SORONG,2232,1954,1880,74,0,10,8,23,24,21,14,19,13,56,35,0,0,65,35,32,91,0,0,57,166,0,2,0,129,94,223,225
2015,1,91,9107,PAPUA BARAT,SORONG,1534,1367,1119,248,0,3,2,4,5,7,7,14,9,44,25,0,0,14,14,23,69,0,0,46,33,7,30,0,72,48,120,116
2015,1,91,9106,PAPUA BARAT,SORONG SELATAN,1882,1883,1617,266,0,20,20,64,63,14,72,66,83,113,124,0,0,167,86,149,237,0,0,140,483,0,15,0,277,362,639,638
2015,1,91,9108,PAPUA BARAT,RAJA AMPAT,217,278,38,240,0,3,5,16,12,18,10,20,10,35,44,0,0,36,28,30,79,0,0,18,16,0,0,0,92,81,173,34
2015,1,91,9105,PAPUA BARAT,MANOKWARI,1215,1094,994,100,0,36,16,99,53,21,32,24,18,120,127,0,0,204,53,42,247,0,14,176,373,0,18,0,300,246,546,567
2015,1,91,9104,PAPUA BARAT,TELUK BINTUNI,1741,1741,1451,290,0,1,0,0,0,1,0,0,0,9,4,0,0,1,1,0,13,0,0,7,8,1,0,0,11,4,15,16
2015,1,91,9103,PAPUA BARAT,TELUK WONDAMA,1283,1288,1267,21,0,15,18,65,63,38,36,17,36,145,149,0,0,161,74,53,294,0,21,248,185,0,11,0,280,302,582,444
2015,1,91,9101,PAPUA BARAT,FAKFAK,1536,1536,1482,54,0,16,21,105,94,49,41,34,26,68,67,0,0,236,90,60,135,0,59,489,30,0,3,0,272,249,521,522
2015,1,91,9102,PAPUA BARAT,KAIMANA,792,792,662,130,0,0,0,0,5,4,2,0,1,12,6,0,0,5,6,1,18,0,0,11,8,0,12,0,16,14,30,31
2015,1,91,9109,PAPUA BARAT,TAMBRAUW,305,300,140,160,0,0,0,2,1,0,15,9,11,35,31,0,0,3,15,20,66,0,0,47,57,0,0,0,46,58,104,104
2015,1,91,9110,PAPUA BARAT,MAYBRAT,121,33,0,33,0,0,0,0,0,0,0,0,1,2,1,0,0,0,0,1,3,0,0,1,3,0,4,0,2,2,4,8
2015,1,91,9112,PAPUA BARAT,PEGUNUNGAN ARFAK,904,904,753,151,0,5,2,37,15,61,47,12,18,70,115,0,0,59,108,30,185,0,0,64,279,0,2,0,185,197,382,345
2015,1,91,9111,PAPUA BARAT,MANOKWARI SELATAN,210,120,80,40,0,1,0,0,0,0,0,4,12,18,23,0,0,1,0,16,41,0,0,19,38,0,1,0,23,35,58,58
2015,1,94,9403,PAPUA,JAYAPURA,6108,6004,5156,848,0,18,17,203,131,195,201,130,91,439,454,0,0,369,396,221,893,0,10,1254,448,23,154,0,985,894,1879,1879
2015,1,94,9471,PAPUA,KOTA JAYAPURA,6021,6021,5817,204,0,12,9,67,57,106,73,79,50,307,237,0,0,145,179,129,544,0,5,638,306,0,29,0,571,426,997,973
2015,1,94,9420,PAPUA,KEEROM,1686,1686,1441,245,0,3,2,36,29,53,35,45,43,143,128,0,0,70,88,88,271,0,1,367,102,1,47,0,280,237,517,517
2015,1,94,9419,PAPUA,SARMI,1084,1214,962,252,0,14,10,63,74,79,73,40,28,158,125,0,0,161,152,68,283,0,0,424,162,0,65,0,354,310,664,651
2015,1,94,9409,PAPUA,BIAK NUMFOR,1745,1735,1640,95,0,6,7,28,19,17,27,17,12,42,67,0,0,60,44,29,109,0,4,22,206,0,14,0,110,132,242,242
2015,1,94,9427,PAPUA,SUPIORI,215,204,142,62,0,4,3,4,6,11,11,8,9,20,36,0,0,17,22,17,56,0,0,57,66,0,2,0,47,65,112,125
2015,1,94,9401,PAPUA,MERAUKE,616,596,403,193,0,2,3,15,16,18,19,16,18,52,32,0,0,36,37,34,84,0,0,1,189,0,1,0,103,88,191,191
2015,1,94,9414,PAPUA,MAPPI,322,296,225,71,0,0,2,5,5,2,2,0,1,14,5,0,0,12,4,1,19,0,0,27,8,0,4,0,21,15,36,39
2015,1,94,9413,PAPUA,BOVEN DIGOEL,665,665,564,101,0,11,7,40,46,26,16,18,9,81,110,0,0,104,42,27,191,0,3,290,65,0,8,0,176,188,364,363
2015,1,94,9404,PAPUA,NABIRE,2842,2842,2374,468,0,9,14,39,46,42,42,39,29,116,127,0,0,108,84,68,243,0,0,231,257,0,15,0,245,258,503,503
2015,1,94,9408,PAPUA,KEPULAUAN YAPEN,2546,2062,1727,335,0,47,45,90,73,67,47,61,52,195,218,0,0,255,114,113,413,0,27,820,57,0,18,0,460,435,895,895
2015,1,94,9412,PAPUA,MIMIKA,13136,13136,12207,929,0,34,29,256,255,229,185,181,160,1240,941,0,0,574,414,341,2181,0,0,1270,1950,103,117,0,1940,1570,3510,3440
2015,1,94,9410,PAPUA,PANIAI,71,71,71,0,0,1,7,12,5,1,0,1,0,16,21,0,0,25,1,1,37,0,0,64,64,0,0,0,31,33,64,128
2015,1,94,9415,PAPUA,ASMAT,523,523,494,29,0,9,9,63,57,37,36,11,19,80,77,0,0,138,73,30,157,0,0,248,143,0,7,0,200,198,398,398
2015,1,94,9426,PAPUA,WAROPEN,427,427,427,0,0,5,5,14,5,14,20,4,8,31,47,0,0,29,34,12,78,0,0,166,2,0,0,0,68,85,153,168
2015,1,94,9402,PAPUA,JAYAWIJAYA,904,904,827,77,0,1,0,8,2,3,6,6,6,49,28,0,0,11,9,12,77,0,0,43,61,0,5,0,67,42,109,109
2015,1,94,9411,PAPUA,PUNCAK JAYA,11,11,0,11,0,59,117,93,109,79,108,101,116,112,387,0,0,378,187,217,499,0,0,259,149,0,31,0,444,837,1281,439
2015,1,94,9418,PAPUA,TOLIKARA,319,319,123,196,0,9,6,22,21,38,28,27,13,67,28,0,0,58,66,40,95,0,0,119,54,0,54,0,163,96,259,227
2015,1,94,9416,PAPUA,YAHUKIMO,276,276,230,46,0,3,2,35,4,17,4,9,5,44,31,0,0,44,21,14,75,0,0,71,91,0,9,0,108,46,154,171
2015,1,94,9417,PAPUA,PEGUNUNGAN BINTANG,0,0,0,0,0,0,0,0,0,0,0,0,0,0,0,0,0,0,0,0,0,0,0,0,0,0,0,0,0,0,0,0
2015,1,94,9428,PAPUA,MAMBERAMO RAYA,78,55,0,55,0,0,0,2,0,2,4,4,6,19,18,0,0,2,6,10,37,0,0,20,23,0,12,0,27,28,55,55
2015,1,94,9429,PAPUA,NDUGA,0,0,0,0,0,0,0,0,0,0,0,0,0,0,0,0,0,0,0,0,0,0,0,0,0,0,0,0,0,0,0,0
2015,1,94,9430,PAPUA,LANNY JAYA,0,0,0,0,0,0,0,0,0,0,0,0,0,0,0,0,0,0,0,0,0,0,0,0,0,0,0,0,0,0,0,0
2015,1,94,9431,PAPUA,MAMBERAMO TENGAH,0,0,0,0,0,0,0,0,0,0,0,0,0,0,0,0,0,0,0,0,0,0,0,0,0,0,0,0,0,0,0,0
2015,1,94,9432,PAPUA,YALIMO,0,0,0,0,0,0,0,0,0,0,0,0,0,0,0,0,0,0,0,0,0,0,0,0,0,0,0,0,0,0,0,0
2015,1,94,9433,PAPUA,PUNCAK,0,0,0,0,0,0,0,0,0,0,0,0,0,0,0,0,0,0,0,0,0,0,0,0,0,0,0,0,0,0,0,0
2015,1,94,9434,PAPUA,DOGIYAI,0,0,0,0,0,0,0,0,0,0,0,0,0,0,0,0,0,0,0,0,0,0,0,0,0,0,0,0,0,0,0,0
2015,1,94,9435,PAPUA,INTAN JAYA,0,0,0,0,0,0,0,0,0,0,0,0,0,0,0,0,0,0,0,0,0,0,0,0,0,0,0,0,0,0,0,0
2015,1,94,9436,PAPUA,DEIYAI,1878,570,15,555,0,2,2,36,38,97,83,75,77,73,86,0,0,78,180,152,159,0,0,315,253,0,0,0,283,286,569,568
2015,2,91,9171,PAPUA BARAT,KOTA SORONG,2475,1799,1698,101,0,13,9,43,26,35,34,31,28,68,56,0,0,91,69,59,124,0,0,95,239,0,5,0,190,153,343,339
2015,2,91,9107,PAPUA BARAT,SORONG,1511,1355,1147,208,0,1,0,7,10,12,5,14,9,22,12,0,0,18,17,23,34,0,0,29,27,9,36,0,56,36,92,101
2015,2,91,9106,PAPUA BARAT,SORONG SELATAN,1632,1637,1373,264,0,18,16,63,50,46,57,54,61,92,108,0,0,147,103,115,200,0,0,120,372,0,11,0,273,292,565,503
2015,2,91,9108,PAPUA BARAT,RAJA AMPAT,217,278,38,240,0,3,5,16,12,18,10,20,10,35,44,0,0,36,28,30,79,0,0,18,16,0,0,0,92,81,173,34
2015,2,91,9105,PAPUA BARAT,MANOKWARI,1114,868,774,94,0,25,24,65,53,34,33,21,14,86,110,0,0,167,67,35,196,0,0,155,294,6,10,0,231,234,465,465
2015,2,91,9104,PAPUA BARAT,TELUK BINTUNI,1510,1510,1227,283,0,0,0,0,0,1,1,0,1,5,1,0,0,0,2,1,6,0,0,4,7,0,0,0,6,3,9,11
2015,2,91,9103,PAPUA BARAT,TELUK WONDAMA,2200,2200,1500,700,0,25,17,60,62,63,35,30,28,99,111,0,0,164,98,58,210,0,5,247,132,0,1,0,277,253,530,380
2015,2,91,9101,PAPUA BARAT,FAKFAK,3539,3539,3468,71,0,44,46,191,187,107,75,55,39,163,194,0,0,468,182,94,357,0,88,1024,69,0,8,0,560,541,1101,1101
2015,2,91,9102,PAPUA BARAT,KAIMANA,844,602,433,169,0,1,0,5,3,3,2,3,2,14,3,0,0,9,5,5,17,0,0,19,6,0,10,0,26,10,36,35
2015,2,91,9109,PAPUA BARAT,TAMBRAUW,211,236,182,54,0,0,1,0,0,3,8,20,17,27,32,0,0,1,11,37,59,0,0,48,60,0,0,0,50,58,108,108
2015,2,91,9110,PAPUA BARAT,MAYBRAT,176,131,98,33,0,0,0,0,0,1,1,1,2,4,3,6,0,0,2,3,7,6,0,4,5,0,2,0,12,6,18,11
2015,2,91,9112,PAPUA BARAT,PEGUNUNGAN ARFAK,662,256,68,188,0,4,0,18,16,24,31,11,10,56,64,0,0,38,55,21,120,0,0,29,171,0,4,0,113,121,234,204
2015,2,91,9111,PAPUA BARAT,MANOKWARI SELATAN,111,111,32,79,0,0,0,0,0,2,1,21,11,31,12,0,0,0,3,32,43,0,0,31,47,0,0,0,54,24,78,78
2015,2,94,9403,PAPUA,JAYAPURA,7037,7037,5617,1420,0,33,22,216,193,321,287,212,172,645,681,0,0,464,608,384,1326,0,10,1901,673,4,186,0,1427,1355,2782,2764
2015,2,94,9471,PAPUA,KOTA JAYAPURA,5455,5455,5351,104,0,5,11,80,64,82,69,48,44,331,236,0,0,160,151,92,567,0,8,604,336,4,34,0,546,424,970,978
2015,2,94,9420,PAPUA,KEEROM,0,0,0,0,0,0,0,0,0,0,0,0,0,0,0,0,0,0,0,0,0,0,0,0,0,0,0,0,0,0,0,0
2015,2,94,9419,PAPUA,SARMI,110,110,109,1,0,0,1,4,1,1,9,2,2,3,10,0,0,6,10,4,13,0,0,20,10,0,3,0,10,23,33,33
2015,2,94,9409,PAPUA,BIAK NUMFOR,1375,1359,1316,43,0,5,1,12,11,5,10,11,4,23,39,0,0,29,15,15,62,0,4,104,12,0,5,0,56,65,121,121
2015,2,94,9427,PAPUA,SUPIORI,429,415,268,147,0,5,1,7,9,5,5,2,1,18,28,0,0,22,10,3,46,0,0,26,53,0,1,0,37,44,81,80
2015,2,94,9401,PAPUA,MERAUKE,961,961,753,208,0,13,15,62,64,54,67,27,30,97,121,0,0,154,121,57,218,0,0,11,539,39,0,0,253,297,550,589
2015,2,94,9414,PAPUA,MAPPI,564,481,302,179,0,1,4,9,8,5,4,3,3,24,8,0,0,22,9,6,32,0,0,45,22,0,5,0,42,27,69,72
2015,2,94,9413,PAPUA,BOVEN DIGOEL,613,613,413,200,0,11,4,28,28,12,9,4,11,35,50,0,0,71,21,15,85,0,0,124,58,0,9,0,90,102,192,191
2015,2,94,9404,PAPUA,NABIRE,4477,4477,3987,490,0,15,17,64,65,62,45,49,47,260,228,0,0,161,107,96,488,0,0,541,287,0,24,0,450,402,852,852
2015,2,94,9408,PAPUA,KEPULAUAN YAPEN,1698,1698,1531,167,0,30,23,58,50,40,35,25,25,64,107,0,0,161,75,50,171,0,27,419,36,0,3,0,217,240,457,458
2015,2,94,9412,PAPUA,MIMIKA,7692,12518,11646,872,0,47,27,290,255,278,232,186,137,1245,998,0,0,619,510,323,2243,0,0,1316,2021,90,77,0,2046,1649,3695,3504
2015,2,94,9410,PAPUA,PANIAI,71,71,71,0,0,0,0,17,34,1,0,0,0,8,19,0,0,51,1,0,27,0,0,74,2,0,0,0,26,53,79,76
2015,2,94,9415,PAPUA,ASMAT,1810,1676,1503,173,0,28,16,88,83,64,55,39,19,179,136,0,0,215,119,58,315,0,0,388,243,0,77,0,398,309,707,708
2015,2,94,9426,PAPUA,WAROPEN,526,526,526,0,0,4,6,19,18,14,25,2,8,40,88,0,0,47,39,10,128,0,0,221,3,0,0,0,79,145,224,224
2015,2,94,9402,PAPUA,JAYAWIJAYA,747,747,677,70,0,1,2,5,6,5,3,2,1,36,24,0,0,14,8,3,60,0,1,38,46,0,0,0,49,36,85,84
2015,2,94,9411,PAPUA,PUNCAK JAYA,0,0,0,0,0,22,34,86,25,147,134,190,140,384,128,0,0,167,281,330,512,0,0,332,143,0,26,0,829,461,1290,501
2015,2,94,9418,PAPUA,TOLIKARA,218,218,101,117,0,2,1,8,9,12,18,20,12,31,8,0,0,20,30,32,39,0,0,51,6,0,0,0,73,48,121,57
2015,2,94,9416,PAPUA,YAHUKIMO,463,463,417,46,0,2,5,18,25,11,11,14,4,65,47,0,0,50,22,18,112,0,0,127,63,1,11,0,110,92,202,202
2015,2,94,9417,PAPUA,PEGUNUNGAN BINTANG,0,0,0,0,0,0,0,0,0,0,0,0,0,0,0,0,0,0,0,0,0,0,0,0,0,0,0,0,0,0,0,0
2015,2,94,9428,PAPUA,MAMBERAMO RAYA,65,5,0,5,0,0,1,0,0,0,0,0,0,2,2,0,0,1,0,0,4,0,0,1,3,0,1,0,2,3,5,5
2015,2,94,9429,PAPUA,NDUGA,0,0,0,0,0,0,0,0,0,0,0,0,0,0,0,0,0,0,0,0,0,0,0,0,0,0,0,0,0,0,0,0
2015,2,94,9430,PAPUA,LANNY JAYA,0,0,0,0,0,0,0,0,0,0,0,0,0,0,0,0,0,0,0,0,0,0,0,0,0,0,0,0,0,0,0,0
2015,2,94,9431,PAPUA,MAMBERAMO TENGAH,0,0,0,0,0,0,0,0,0,0,0,0,0,0,0,0,0,0,0,0,0,0,0,0,0,0,0,0,0,0,0,0
2015,2,94,9432,PAPUA,YALIMO,0,0,0,0,0,0,0,0,0,0,0,0,0,0,0,0,0,0,0,0,0,0,0,0,0,0,0,0,0,0,0,0
2015,2,94,9433,PAPUA,PUNCAK,0,0,0,0,0,0,0,0,0,0,0,0,0,0,0,0,0,0,0,0,0,0,0,0,0,0,0,0,0,0,0,0
2015,2,94,9434,PAPUA,DOGIYAI,28,28,28,0,0,0,0,0,0,0,0,0,0,0,0,0,0,0,0,0,0,0,0,0,7,0,1,0,0,0,0,8
2015,2,94,9435,PAPUA,INTAN JAYA,0,0,0,0,0,0,0,0,0,0,0,0,0,0,0,0,0,0,0,0,0,0,0,0,0,0,0,0,0,0,0,0
2015,2,94,9436,PAPUA,DEIYAI,642,642,20,622,0,0,0,51,49,74,77,84,90,104,111,0,0,100,151,174,215,0,0,0,0,0,0,0,313,327,640,0
2015,3,91,9171,PAPUA BARAT,KOTA SORONG,2459,2656,2059,597,0,5,3,16,16,23,11,15,11,38,25,0,0,40,34,26,63,0,0,85,173,0,3,0,97,66,163,261
2015,3,91,9107,PAPUA BARAT,SORONG,1224,1096,917,179,0,0,1,3,3,8,3,4,3,6,7,0,0,7,11,7,13,0,0,15,18,0,13,0,21,17,38,46
2015,3,91,9106,PAPUA BARAT,SORONG SELATAN,1621,1627,1429,198,0,27,20,41,54,64,53,54,44,95,90,0,0,142,117,98,185,0,3,143,350,0,6,0,281,261,542,499
2015,3,91,9108,PAPUA BARAT,RAJA AMPAT,115,118,12,106,0,1,1,1,3,6,5,4,3,31,14,0,0,6,11,7,45,0,3,11,23,0,22,0,43,26,69,56
2015,3,91,9105,PAPUA BARAT,MANOKWARI,918,857,697,160,0,0,2,4,11,18,12,31,16,97,83,0,0,17,30,47,180,0,0,157,212,0,8,0,150,124,274,377
2015,3,91,9104,PAPUA BARAT,TELUK BINTUNI,1610,1610,1366,244,0,0,0,1,0,0,0,1,0,0,0,0,0,1,0,1,0,0,0,3,5,0,1,0,2,0,2,9
2015,3,91,9103,PAPUA BARAT,TELUK WONDAMA,949,949,924,25,0,18,16,36,27,38,29,24,41,73,121,0,0,97,67,65,194,0,32,243,77,0,0,0,189,234,423,320
2015,3,91,9101,PAPUA BARAT,FAKFAK,2921,2921,2808,113,0,25,30,98,91,42,42,18,17,54,68,0,0,244,84,35,122,0,28,543,56,0,2,0,237,248,485,601
2015,3,91,9102,PAPUA BARAT,KAIMANA,776,776,559,217,0,0,0,4,1,1,2,1,2,13,5,0,0,5,3,3,18,0,0,11,9,0,9,0,19,10,29,29
2015,3,91,9109,PAPUA BARAT,TAMBRAUW,318,161,129,32,0,2,0,2,4,7,11,21,9,31,46,0,0,8,18,30,77,0,0,68,52,0,0,0,63,70,133,120
2015,3,91,9110,PAPUA BARAT,MAYBRAT,157,46,0,46,0,0,0,3,4,1,3,3,0,4,4,0,0,7,4,3,8,0,0,12,10,0,0,0,11,11,22,22
2015,3,91,9112,PAPUA BARAT,PEGUNUNGAN ARFAK,825,821,609,212,0,9,10,17,26,38,35,11,18,50,92,0,0,62,73,29,142,0,0,53,225,1,4,0,125,181,306,283
2015,3,91,9111,PAPUA BARAT,MANOKWARI SELATAN,90,90,53,37,0,0,0,0,0,2,3,6,9,11,21,0,0,0,5,15,32,0,0,31,21,0,0,0,19,33,52,52
2015,3,94,9403,PAPUA,JAYAPURA,6491,6490,5132,1358,0,29,17,173,168,258,220,177,168,582,692,0,0,387,478,345,1274,0,0,1636,639,2,216,0,1219,1265,2484,2493
2015,3,94,9471,PAPUA,KOTA JAYAPURA,4626,0,0,0,0,0,0,0,0,0,0,0,0,0,0,0,0,0,0,0,0,0,2,0,0,0,0,0,0,0,0,0
2015,3,94,9420,PAPUA,KEEROM,1631,1631,1205,426,0,3,2,3,53,56,44,44,45,140,150,0,0,61,100,89,290,0,4,351,116,0,124,0,246,294,540,591
2015,3,94,9419,PAPUA,SARMI,712,678,516,162,0,1,4,35,25,36,32,19,16,92,54,0,0,65,68,35,146,0,0,200,69,0,43,0,183,131,314,312
2015,3,94,9409,PAPUA,BIAK NUMFOR,0,0,0,0,0,0,0,0,0,0,0,0,0,0,0,0,0,0,0,0,0,0,3,0,0,0,0,0,0,0,0,0
2015,3,94,9427,PAPUA,SUPIORI,170,170,54,116,0,0,2,2,4,2,2,4,2,14,16,0,0,8,4,6,30,0,0,27,20,0,1,0,22,26,48,48
2015,3,94,9401,PAPUA,MERAUKE,0,0,0,0,0,0,0,0,0,0,0,0,0,0,0,0,0,0,0,0,0,0,0,0,0,0,0,0,0,0,0,0
2015,3,94,9414,PAPUA,MAPPI,423,539,245,294,0,1,8,16,8,2,4,2,2,14,20,0,0,33,6,4,34,0,2,53,19,0,7,0,35,42,77,79
2015,3,94,9413,PAPUA,BOVEN DIGOEL,515,515,426,89,0,12,2,35,22,18,11,9,9,32,45,0,0,71,29,18,77,0,2,106,73,0,16,0,106,89,195,195
2015,3,94,9404,PAPUA,NABIRE,3551,3551,2896,655,0,15,15,39,51,42,52,61,84,167,156,0,0,120,94,145,323,0,2,380,276,3,23,0,324,358,682,682
2015,3,94,9408,PAPUA,KEPULAUAN YAPEN,32,32,32,0,0,3,0,4,3,4,0,4,1,6,7,0,0,10,4,5,13,0,29,31,0,0,1,0,21,11,32,32
2015,3,94,9412,PAPUA,MIMIKA,0,0,0,0,0,0,0,0,0,0,0,0,0,0,0,0,0,0,0,0,0,0,0,0,0,0,0,0,0,0,0,0
2015,3,94,9410,PAPUA,PANIAI,245,245,125,120,0,0,0,42,46,9,14,8,14,48,58,0,0,88,23,22,106,0,0,119,0,0,0,0,107,132,239,119
2015,3,94,9415,PAPUA,ASMAT,0,0,0,0,0,0,0,0,0,0,0,0,0,0,0,0,0,0,0,0,0,0,0,0,0,0,0,0,0,0,0,0
2015,3,94,9426,PAPUA,WAROPEN,282,586,586,0,0,8,4,16,24,14,17,5,11,45,76,0,0,52,31,16,121,0,0,111,3,0,0,0,88,132,220,114
2015,3,94,9402,PAPUA,JAYAWIJAYA,322,322,270,52,0,0,0,1,1,1,4,0,0,14,6,0,0,2,5,0,20,0,1,7,20,0,0,0,16,11,27,27
2015,3,94,9411,PAPUA,PUNCAK JAYA,0,0,0,0,0,0,0,0,0,0,0,0,0,0,0,0,0,0,0,0,0,0,0,0,0,0,0,0,0,0,0,0
2015,3,94,9418,PAPUA,TOLIKARA,0,0,0,0,0,0,0,0,0,0,0,0,0,0,0,0,0,0,0,0,0,0,0,0,0,0,0,0,0,0,0,0
2015,3,94,9416,PAPUA,YAHUKIMO,0,0,0,0,0,0,0,0,0,0,0,0,0,0,0,0,0,0,0,0,0,0,0,0,0,0,0,0,0,0,0,0
2015,3,94,9417,PAPUA,PEGUNUNGAN BINTANG,0,0,0,0,0,0,0,0,0,0,0,0,0,0,0,0,0,0,0,0,0,0,0,0,0,0,0,0,0,0,0,0
2015,3,94,9428,PAPUA,MAMBERAMO RAYA,0,0,0,0,0,0,0,0,0,0,0,0,0,0,0,0,0,0,0,0,0,0,0,0,0,0,0,0,0,0,0,0
2015,3,94,9429,PAPUA,NDUGA,0,0,0,0,0,0,0,0,0,0,0,0,0,0,0,0,0,0,0,0,0,0,0,0,0,0,0,0,0,0,0,0
2015,3,94,9430,PAPUA,LANNY JAYA,0,0,0,0,0,0,0,0,0,0,0,0,0,0,0,0,0,0,0,0,0,0,0,0,0,0,0,0,0,0,0,0
2015,3,94,9431,PAPUA,MAMBERAMO TENGAH,0,0,0,0,0,0,0,0,0,0,0,0,0,0,0,0,0,0,0,0,0,0,0,0,0,0,0,0,0,0,0,0
2015,3,94,9432,PAPUA,YALIMO,506,506,472,34,0,5,4,16,13,15,7,18,12,86,50,0,0,38,22,30,136,0,0,134,77,1,14,0,140,86,226,226
2015,3,94,9433,PAPUA,PUNCAK,0,0,0,0,0,0,0,0,0,0,0,0,0,0,0,0,0,0,0,0,0,0,0,0,0,0,0,0,0,0,0,0
2015,3,94,9434,PAPUA,DOGIYAI,0,0,0,0,0,0,0,0,0,0,0,0,0,0,0,0,0,0,0,0,0,0,0,0,0,0,0,0,0,0,0,0
2015,3,94,9435,PAPUA,INTAN JAYA,0,0,0,0,0,0,0,0,0,0,0,0,0,0,0,0,0,0,0,0,0,0,0,0,0,0,0,0,0,0,0,0
2015,3,94,9436,PAPUA,DEIYAI,0,0,0,0,0,0,0,0,0,0,0,0,0,0,0,0,0,0,0,0,0,0,0,0,0,0,0,0,0,0,0,0
2015,4,91,9171,PAPUA BARAT,KOTA SORONG,1576,1388,1138,250,0,0,1,9,5,7,4,4,5,39,30,0,0,15,11,9,69,0,0,24,76,0,3,0,59,45,104,103
2015,4,91,9107,PAPUA BARAT,SORONG,890,890,717,173,0,0,1,5,2,5,1,7,2,9,5,0,0,8,6,9,14,0,3,3,7,0,11,0,26,11,37,21
2015,4,91,9106,PAPUA BARAT,SORONG SELATAN,1434,1434,1288,146,0,8,12,37,56,63,39,35,46,101,131,0,0,113,102,81,232,0,14,136,276,0,7,0,244,284,528,419
2015,4,91,9108,PAPUA BARAT,RAJA AMPAT,5,5,5,0,0,0,0,2,0,0,1,1,0,1,0,0,0,2,1,1,1,0,0,2,3,0,0,0,4,1,5,5
2015,4,91,9105,PAPUA BARAT,MANOKWARI,1107,1044,763,281,0,39,18,87,60,37,28,19,12,90,109,0,0,204,65,31,199,0,0,99,366,0,19,0,272,227,499,484
2015,4,91,9104,PAPUA BARAT,TELUK BINTUNI,1368,1368,1140,228,0,0,0,0,2,0,0,0,0,2,1,0,0,2,0,0,3,0,1,1,4,0,1,0,2,3,5,6
2015,4,91,9103,PAPUA BARAT,TELUK WONDAMA,1326,1326,785,541,0,41,28,56,36,57,47,34,47,109,100,0,0,161,104,81,209,0,7,244,81,0,2,0,297,258,555,327
2015,4,91,9101,PAPUA BARAT,FAKFAK,2469,2469,2380,89,0,34,22,98,79,46,52,20,20,55,63,0,0,233,98,40,118,0,45,439,49,0,1,0,253,236,489,489
2015,4,91,9102,PAPUA BARAT,KAIMANA,561,556,476,80,0,0,1,0,0,1,4,1,1,8,2,0,0,1,5,2,10,0,0,8,10,0,0,0,10,8,18,18
2015,4,91,9109,PAPUA BARAT,TAMBRAUW,431,431,269,162,0,8,4,9,5,11,7,16,21,35,32,0,0,26,18,37,67,0,0,90,58,0,0,0,79,69,148,148
2015,4,91,9110,PAPUA BARAT,MAYBRAT,145,29,0,29,0,0,0,2,1,0,1,1,0,2,1,0,0,3,1,1,3,0,0,3,5,0,0,0,5,3,8,8
2015,4,91,9112,PAPUA BARAT,PEGUNUNGAN ARFAK,597,593,488,105,0,6,6,14,21,20,17,5,6,45,56,0,0,47,37,11,101,0,0,26,173,0,1,0,90,106,196,200
2015,4,91,9111,PAPUA BARAT,MANOKWARI SELATAN,211,211,125,86,0,2,2,7,3,11,7,21,18,28,12,0,0,14,18,39,40,0,0,72,40,0,0,0,69,42,111,112
2015,4,94,9403,PAPUA,JAYAPURA,5812,5812,4291,1521,0,19,30,171,164,224,170,143,105,423,472,0,0,384,394,248,895,0,7,1224,482,5,212,0,980,941,1921,1923
2015,4,94,9471,PAPUA,KOTA JAYAPURA,0,0,0,0,0,0,0,0,0,0,0,0,0,0,0,0,0,0,0,0,0,0,0,0,0,0,0,0,0,0,0,0
2015,4,94,9420,PAPUA,KEEROM,3366,3366,2344,1022,0,9,7,130,94,123,96,114,90,408,340,0,0,240,219,204,748,0,0,870,324,1,216,0,784,627,1411,1411
2015,4,94,9419,PAPUA,SARMI,1067,1067,899,168,0,11,5,76,53,51,59,18,21,124,110,0,0,145,110,39,234,0,0,304,141,0,86,0,280,248,528,531
2015,4,94,9409,PAPUA,BIAK NUMFOR,0,0,0,0,0,0,0,0,0,0,0,0,0,0,0,0,0,0,0,0,0,0,4,0,0,0,0,0,0,0,0,0
2015,4,94,9427,PAPUA,SUPIORI,189,169,75,94,0,0,1,9,4,3,4,0,1,3,9,0,0,14,7,1,12,0,0,9,22,0,3,0,15,19,34,34
2015,4,94,9401,PAPUA,MERAUKE,352,352,274,78,0,14,16,94,82,72,71,52,44,164,125,0,0,206,143,96,289,0,0,3,264,0,3,0,396,338,734,270
2015,4,94,9414,PAPUA,MAPPI,622,608,381,227,0,5,2,19,18,11,5,5,4,32,25,0,0,44,16,9,57,0,0,91,30,0,7,0,72,54,126,128
2015,4,94,9413,PAPUA,BOVEN DIGOEL,747,747,532,215,0,16,6,43,25,18,30,9,16,61,110,0,0,90,48,25,171,0,3,197,121,0,16,0,147,187,334,334
2015,4,94,9404,PAPUA,NABIRE,3890,3890,3270,620,0,41,35,72,68,66,63,60,74,255,217,0,0,216,129,134,472,0,3,612,324,0,15,0,494,457,951,951
2015,4,94,9408,PAPUA,KEPULAUAN YAPEN,0,0,0,0,0,0,0,0,0,0,0,0,0,0,0,0,0,0,0,0,0,0,26,0,0,0,0,0,0,0,0,0
2015,4,94,9412,PAPUA,MIMIKA,0,0,0,0,0,0,0,0,0,0,0,0,0,0,0,0,0,0,0,0,0,0,0,0,0,0,0,0,0,0,0,0
2015,4,94,9410,PAPUA,PANIAI,302,302,197,105,0,15,10,44,41,27,21,12,15,41,62,0,0,110,48,27,103,0,0,193,4,0,0,0,139,149,288,197
2015,4,94,9415,PAPUA,ASMAT,936,936,630,306,0,15,14,75,73,46,37,30,23,91,76,0,0,177,83,53,167,0,0,329,112,0,49,0,257,223,480,490
2015,4,94,9426,PAPUA,WAROPEN,0,0,0,0,0,0,0,0,0,0,0,0,0,0,0,0,0,0,0,0,0,0,0,0,0,0,0,0,0,0,0,0
2015,4,94,9402,PAPUA,JAYAWIJAYA,577,577,576,1,0,0,0,5,1,2,1,1,0,44,26,0,0,6,3,1,70,0,0,37,43,0,0,0,52,28,80,80
2015,4,94,9411,PAPUA,PUNCAK JAYA,0,0,0,0,0,0,0,0,0,0,0,0,0,0,0,0,0,0,0,0,0,0,0,0,0,0,0,0,0,0,0,0
2015,4,94,9418,PAPUA,TOLIKARA,0,0,0,0,0,0,0,0,0,0,0,0,0,0,0,0,0,0,0,0,0,0,0,0,0,0,0,0,0,0,0,0
2015,4,94,9416,PAPUA,YAHUKIMO,0,0,0,0,0,0,0,0,0,0,0,0,0,0,0,0,0,0,0,0,0,0,0,0,0,0,0,0,0,0,0,0
2015,4,94,9417,PAPUA,PEGUNUNGAN BINTANG,0,0,0,0,0,0,0,0,0,0,0,0,0,0,0,0,0,0,0,0,0,0,0,0,0,0,0,0,0,0,0,0
2015,4,94,9428,PAPUA,MAMBERAMO RAYA,0,0,0,0,0,0,0,0,0,0,0,0,0,0,0,0,0,0,0,0,0,0,0,0,0,0,0,0,0,0,0,0
2015,4,94,9429,PAPUA,NDUGA,0,0,0,0,0,0,0,0,0,0,0,0,0,0,0,0,0,0,0,0,0,0,0,0,0,0,0,0,0,0,0,0
2015,4,94,9430,PAPUA,LANNY JAYA,18,18,18,0,0,0,0,0,0,1,0,0,0,0,0,0,0,0,1,0,0,0,0,0,0,0,0,0,1,0,1,0
2015,4,94,9431,PAPUA,MAMBERAMO TENGAH,0,0,0,0,0,0,0,0,0,0,0,0,0,0,0,0,0,0,0,0,0,0,0,0,0,0,0,0,0,0,0,0
2015,4,94,9432,PAPUA,YALIMO,0,0,0,0,0,0,0,0,0,0,0,0,0,0,0,0,0,0,0,0,0,0,0,0,0,0,0,0,0,0,0,0
2015,4,94,9433,PAPUA,PUNCAK,0,0,0,0,0,0,0,0,0,0,0,0,0,0,0,0,0,0,0,0,0,0,0,0,0,0,0,0,0,0,0,0
2015,4,94,9434,PAPUA,DOGIYAI,0,0,0,0,0,0,0,0,0,0,0,0,0,0,0,0,0,0,0,0,0,0,0,0,0,0,0,0,0,0,0,0
2015,4,94,9435,PAPUA,INTAN JAYA,0,0,0,0,0,0,0,0,0,0,0,0,0,0,0,0,0,0,0,0,0,0,0,0,0,0,0,0,0,0,0,0
2015,4,94,9436,PAPUA,DEIYAI,0,0,0,0,0,0,0,0,0,0,0,0,0,0,0,0,0,0,0,0,0,0,0,0,0,0,0,0,0,0,0,0
2015,5,91,9171,PAPUA BARAT,KOTA SORONG,1237,1136,917,219,0,4,3,6,3,6,4,4,3,19,11,0,0,16,10,7,30,0,0,20,42,0,1,0,39,24,63,63
2015,5,91,9107,PAPUA BARAT,SORONG,933,927,760,167,0,1,0,2,4,3,5,1,0,12,3,0,0,7,8,1,15,0,0,5,8,0,3,0,19,12,31,16
2015,5,91,9106,PAPUA BARAT,SORONG SELATAN,1756,1756,1596,160,0,6,3,45,72,48,42,72,57,110,124,0,0,126,90,129,234,0,0,126,302,0,16,0,281,298,579,444
2015,5,91,9108,PAPUA BARAT,RAJA AMPAT,201,201,189,12,0,0,0,2,1,4,6,5,7,9,18,0,0,3,10,12,27,0,0,21,29,0,2,0,20,32,52,52
2015,5,91,9105,PAPUA BARAT,MANOKWARI,979,869,683,186,0,27,22,62,39,20,17,16,16,64,87,0,0,150,37,32,151,0,0,126,250,0,7,0,189,181,370,383
2015,5,91,9104,PAPUA BARAT,TELUK BINTUNI,1038,1038,938,100,0,0,0,0,0,0,0,0,0,0,0,0,0,0,0,0,0,0,0,0,4,0,0,0,0,0,0,4
2015,5,91,9103,PAPUA BARAT,TELUK WONDAMA,1297,1300,950,350,0,19,13,46,54,73,34,33,32,110,137,0,0,132,107,65,247,0,3,229,53,0,3,0,281,270,551,285
2015,5,91,9101,PAPUA BARAT,FAKFAK,2309,2309,2190,119,0,12,6,42,46,26,10,8,6,33,37,0,0,106,36,14,70,0,25,203,23,0,0,0,121,105,226,226
2015,5,91,9102,PAPUA BARAT,KAIMANA,346,313,213,100,0,0,1,2,1,1,0,2,0,2,1,0,0,4,1,2,3,0,0,5,5,0,0,0,7,3,10,10
2015,5,91,9109,PAPUA BARAT,TAMBRAUW,305,300,140,160,0,0,0,2,1,0,15,9,11,35,31,0,0,3,15,20,66,0,0,47,57,0,0,0,46,58,104,104
2015,5,91,9110,PAPUA BARAT,MAYBRAT,157,34,0,34,0,0,1,0,0,0,0,0,0,3,2,0,0,1,0,0,5,0,0,0,2,0,0,0,3,3,6,2
2015,5,91,9112,PAPUA BARAT,PEGUNUNGAN ARFAK,611,611,526,85,0,4,0,18,25,17,9,3,2,32,46,0,0,47,26,5,78,0,0,23,146,0,4,0,74,82,156,173
2015,5,91,9111,PAPUA BARAT,MANOKWARI SELATAN,210,120,80,40,0,1,0,0,0,0,0,4,12,18,13,0,0,1,0,16,31,0,0,19,38,0,1,0,23,25,48,58
2015,5,94,9403,PAPUA,JAYAPURA,10953,5839,4420,1419,0,28,28,184,191,216,172,51,134,511,508,0,0,431,388,185,1019,0,6,1376,589,1,236,0,990,1033,2023,2202
2015,5,94,9471,PAPUA,KOTA JAYAPURA,4291,4291,4088,203,0,14,9,45,56,49,0,0,0,0,0,0,0,124,49,0,0,0,10,0,0,0,0,0,108,65,173,0
2015,5,94,9420,PAPUA,KEEROM,3187,3187,2107,1080,0,7,7,108,89,155,110,97,70,361,335,0,0,211,265,167,696,0,0,814,339,1,184,0,728,611,1339,1338
2015,5,94,9419,PAPUA,SARMI,485,485,385,100,0,5,4,48,22,28,42,20,28,72,74,0,0,79,70,48,146,0,0,220,99,0,25,0,173,170,343,344
2015,5,94,9409,PAPUA,BIAK NUMFOR,0,0,0,0,0,0,0,0,0,0,0,0,0,0,0,0,0,0,0,0,0,0,0,0,0,0,0,0,0,0,0,0
2015,5,94,9427,PAPUA,SUPIORI,79,50,50,0,0,2,0,4,2,5,4,0,0,12,13,0,0,8,9,0,25,0,0,9,31,0,2,0,23,19,42,42
2015,5,94,9401,PAPUA,MERAUKE,0,197,165,32,0,4,5,20,17,17,22,15,19,35,87,0,0,46,39,34,122,0,0,66,151,0,0,0,91,150,241,217
2015,5,94,9414,PAPUA,MAPPI,623,623,344,279,0,1,0,8,8,9,7,29,17,14,9,0,0,17,16,46,23,0,0,69,26,0,7,0,61,41,102,102
2015,5,94,9413,PAPUA,BOVEN DIGOEL,711,711,522,189,0,5,2,26,36,15,24,11,12,50,61,0,0,69,39,23,111,0,0,104,97,0,40,0,107,135,242,241
2015,5,94,9404,PAPUA,NABIRE,3978,3978,3370,608,0,20,11,67,54,57,48,73,72,285,217,0,0,152,105,145,502,0,3,460,430,0,18,0,502,402,904,908
2015,5,94,9408,PAPUA,KEPULAUAN YAPEN,0,617,542,75,0,24,25,18,19,20,0,0,0,0,0,0,0,86,20,0,0,0,24,0,0,0,0,0,62,44,106,0
2015,5,94,9412,PAPUA,MIMIKA,0,1600,1253,347,0,27,12,74,65,82,0,0,0,0,0,0,0,178,82,0,0,0,0,0,0,0,0,0,183,77,260,0
2015,5,94,9410,PAPUA,PANIAI,0,0,0,0,0,0,0,0,0,0,0,0,0,0,0,0,0,0,0,0,0,0,0,0,0,0,0,0,0,0,0,0
2015,5,94,9415,PAPUA,ASMAT,1213,1240,893,347,0,23,16,87,97,47,49,34,35,138,110,0,0,223,96,69,248,0,0,443,126,0,69,0,329,307,636,638
2015,5,94,9426,PAPUA,WAROPEN,0,0,0,0,0,0,0,0,0,0,0,0,0,0,0,0,0,0,0,0,0,0,0,0,0,0,0,0,0,0,0,0
2015,5,94,9402,PAPUA,JAYAWIJAYA,364,364,363,1,0,2,2,4,1,4,3,2,0,20,17,0,0,9,7,2,37,0,1,18,37,0,0,0,32,23,55,55
2015,5,94,9411,PAPUA,PUNCAK JAYA,0,0,0,0,0,22,23,66,65,0,0,0,0,0,0,0,0,176,0,0,0,0,0,0,0,0,0,0,88,88,176,0
2015,5,94,9418,PAPUA,TOLIKARA,104,104,54,50,0,4,4,7,9,0,0,0,0,0,0,0,0,24,0,0,0,0,0,0,0,0,0,0,11,13,24,0
2015,5,94,9416,PAPUA,YAHUKIMO,0,0,0,0,0,0,0,0,0,0,0,0,0,0,0,0,0,0,0,0,0,0,0,0,0,0,0,0,0,0,0,0
2015,5,94,9417,PAPUA,PEGUNUNGAN BINTANG,0,0,0,0,0,0,0,0,0,0,0,0,0,0,0,0,0,0,0,0,0,0,0,0,0,0,0,0,0,0,0,0
2015,5,94,9428,PAPUA,MAMBERAMO RAYA,102,5,0,5,0,0,0,1,1,0,0,0,0,0,0,0,0,2,0,0,0,0,0,0,0,0,0,0,1,1,2,0
2015,5,94,9429,PAPUA,NDUGA,0,0,0,0,0,0,0,0,0,0,0,0,0,0,0,0,0,0,0,0,0,0,0,0,0,0,0,0,0,0,0,0
2015,5,94,9430,PAPUA,LANNY JAYA,0,0,0,0,0,0,0,0,0,0,0,0,0,0,0,0,0,0,0,0,0,0,0,0,0,0,0,0,0,0,0,0
2015,5,94,9431,PAPUA,MAMBERAMO TENGAH,0,0,0,0,0,0,0,0,0,0,0,0,0,0,0,0,0,0,0,0,0,0,0,0,0,0,0,0,0,0,0,0
2015,5,94,9432,PAPUA,YALIMO,0,0,0,0,0,0,0,0,0,0,0,0,0,0,0,0,0,0,0,0,0,0,0,0,0,0,0,0,0,0,0,0
2015,5,94,9433,PAPUA,PUNCAK,0,0,0,0,0,0,0,0,0,0,0,0,0,0,0,0,0,0,0,0,0,0,0,0,0,0,0,0,0,0,0,0
2015,5,94,9434,PAPUA,DOGIYAI,0,0,0,0,0,0,0,0,0,0,0,0,0,0,0,0,0,0,0,0,0,0,0,0,0,0,0,0,0,0,0,0
2015,5,94,9435,PAPUA,INTAN JAYA,0,0,0,0,0,0,0,0,0,0,0,0,0,0,0,0,0,0,0,0,0,0,0,0,0,0,0,0,0,0,0,0
2015,5,94,9436,PAPUA,DEIYAI,0,0,0,0,0,0,0,0,0,0,0,0,0,0,0,0,0,0,0,0,0,0,0,0,0,0,0,0,0,0,0,0
2015,6,91,9171,PAPUA BARAT,KOTA SORONG,2779,2902,2776,126,0,12,9,36,27,33,37,34,21,80,64,0,0,84,70,55,144,0,0,142,195,0,5,0,195,158,353,342
2015,6,91,9107,PAPUA BARAT,SORONG,765,765,635,130,0,1,0,4,2,3,2,5,0,10,6,0,0,7,5,5,16,0,0,6,10,0,17,0,23,10,33,33
2015,6,91,9106,PAPUA BARAT,SORONG SELATAN,599,611,487,124,0,12,6,20,17,7,5,4,3,24,38,0,0,55,12,7,62,0,0,14,115,0,1,0,67,69,136,130
2015,6,91,9108,PAPUA BARAT,RAJA AMPAT,130,130,118,12,0,0,0,1,0,10,0,1,0,23,0,0,0,1,10,1,23,0,0,28,28,0,3,0,35,0,35,59
2015,6,91,9105,PAPUA BARAT,MANOKWARI,842,712,547,165,0,2,3,19,18,10,15,3,13,40,68,0,0,42,25,16,108,0,1,102,84,0,2,0,74,117,191,188
2015,6,91,9104,PAPUA BARAT,TELUK BINTUNI,274,274,170,104,0,0,0,0,0,2,0,0,0,0,0,0,0,0,2,0,0,0,0,1,1,0,0,0,2,0,2,2
2015,6,91,9103,PAPUA BARAT,TELUK WONDAMA,3488,3486,3361,125,0,44,43,77,94,116,75,56,62,194,262,0,0,258,191,118,456,0,45,194,401,0,2,0,487,536,1023,597
2015,6,91,9101,PAPUA BARAT,FAKFAK,1805,1805,1787,18,0,15,16,44,35,26,31,7,11,52,44,0,0,110,57,18,96,0,0,267,16,0,1,0,144,137,281,284
2015,6,91,9102,PAPUA BARAT,KAIMANA,0,0,0,0,0,0,0,0,0,0,0,0,0,0,0,0,0,0,0,0,0,0,0,0,0,0,0,0,0,0,0,0
2015,6,91,9109,PAPUA BARAT,TAMBRAUW,274,197,143,54,0,0,1,0,0,3,8,20,17,27,32,0,0,1,11,37,59,0,0,48,60,0,0,0,50,58,108,108
2015,6,91,9110,PAPUA BARAT,MAYBRAT,176,33,0,33,0,0,0,0,0,1,1,1,2,4,3,0,0,0,2,3,7,0,0,4,5,0,2,0,6,6,12,11
2015,6,91,9112,PAPUA BARAT,PEGUNUNGAN ARFAK,701,662,474,188,0,4,0,18,16,24,31,11,10,56,64,0,0,38,55,21,120,0,0,29,171,0,4,0,113,121,234,204
2015,6,91,9111,PAPUA BARAT,MANOKWARI SELATAN,156,111,32,79,0,0,0,0,0,2,1,21,11,31,12,0,0,0,3,32,43,0,0,31,47,0,0,0,54,24,78,78
2015,6,94,9403,PAPUA,JAYAPURA,6271,6295,4892,1403,0,23,25,207,226,232,187,136,124,547,512,0,0,481,419,260,1059,0,20,1492,490,7,230,0,1145,1074,2219,2219
2015,6,94,9471,PAPUA,KOTA JAYAPURA,0,0,0,0,0,0,0,0,0,0,0,0,0,0,0,0,0,0,0,0,0,0,0,0,0,0,0,0,0,0,0,0
2015,6,94,9420,PAPUA,KEEROM,0,0,0,0,0,0,0,0,0,0,0,0,0,0,0,0,0,0,0,0,0,0,8,0,0,0,0,0,0,0,0,0
2015,6,94,9419,PAPUA,SARMI,0,0,0,0,0,0,0,0,0,0,0,0,0,0,0,0,0,0,0,0,0,0,0,0,0,0,0,0,0,0,0,0
2015,6,94,9409,PAPUA,BIAK NUMFOR,485,485,414,71,0,0,0,2,0,1,1,1,0,0,9,0,0,2,2,1,9,0,0,1,11,0,2,0,4,10,14,14
2015,6,94,9427,PAPUA,SUPIORI,424,51,51,0,0,1,0,1,2,0,0,1,0,2,3,0,0,4,0,1,5,0,0,6,4,0,0,0,5,5,10,10
2015,6,94,9401,PAPUA,MERAUKE,178,138,96,42,0,4,4,4,10,11,10,4,4,33,28,0,0,22,21,8,61,0,0,41,0,0,1,0,56,56,112,42
2015,6,94,9414,PAPUA,MAPPI,735,735,486,249,0,3,3,16,10,10,11,5,5,32,17,0,0,32,21,10,49,0,0,86,24,0,3,0,66,46,112,113
2015,6,94,9413,PAPUA,BOVEN DIGOEL,421,421,233,188,0,6,3,24,24,13,10,8,10,70,36,0,0,57,23,18,106,0,0,108,75,0,21,0,121,83,204,204
2015,6,94,9404,PAPUA,NABIRE,3247,3247,2954,293,0,3,7,30,37,35,52,84,76,250,245,0,0,77,87,160,495,0,0,363,436,1,16,0,402,417,819,816
2015,6,94,9408,PAPUA,KEPULAUAN YAPEN,0,0,0,0,0,0,0,0,0,0,0,0,0,0,0,0,0,0,0,0,0,0,0,0,0,0,0,0,0,0,0,0
2015,6,94,9412,PAPUA,MIMIKA,0,0,0,0,0,0,0,0,0,0,0,0,0,0,0,0,0,0,0,0,0,0,0,0,0,0,0,0,0,0,0,0
2015,6,94,9410,PAPUA,PANIAI,181,181,181,0,0,18,15,20,19,13,6,20,4,23,40,0,0,72,19,24,63,0,0,153,5,0,0,0,94,84,178,158
2015,6,94,9415,PAPUA,ASMAT,1645,1645,1465,180,0,14,11,87,72,65,59,0,17,137,98,0,0,184,124,17,235,0,7,418,136,0,26,0,303,257,560,580
2015,6,94,9426,PAPUA,WAROPEN,0,0,0,0,0,0,0,0,0,0,0,0,0,0,0,0,0,0,0,0,0,0,0,0,0,0,0,0,0,0,0,0
2015,6,94,9402,PAPUA,JAYAWIJAYA,246,246,0,246,0,0,0,4,3,1,2,0,0,11,7,0,0,7,3,0,18,0,0,16,12,0,0,0,16,12,28,28
2015,6,94,9411,PAPUA,PUNCAK JAYA,0,0,0,0,0,0,0,0,0,0,0,0,0,0,0,0,0,0,0,0,0,0,0,0,0,0,0,0,0,0,0,0
2015,6,94,9418,PAPUA,TOLIKARA,0,0,0,0,0,0,0,0,0,0,0,0,0,0,0,0,0,0,0,0,0,0,0,0,0,0,0,0,0,0,0,0
2015,6,94,9416,PAPUA,YAHUKIMO,0,0,0,0,0,0,0,0,0,0,0,0,0,0,0,0,0,0,0,0,0,0,0,0,0,0,0,0,0,0,0,0
2015,6,94,9417,PAPUA,PEGUNUNGAN BINTANG,0,0,0,0,0,0,0,0,0,0,0,0,0,0,0,0,0,0,0,0,0,0,0,0,0,0,0,0,0,0,0,0
2015,6,94,9428,PAPUA,MAMBERAMO RAYA,0,0,0,0,0,0,0,0,0,0,0,0,0,0,0,0,0,0,0,0,0,0,0,0,0,0,0,0,0,0,0,0
2015,6,94,9429,PAPUA,NDUGA,0,0,0,0,0,0,0,0,0,0,0,0,0,0,0,0,0,0,0,0,0,0,0,0,0,0,0,0,0,0,0,0
2015,6,94,9430,PAPUA,LANNY JAYA,0,0,0,0,0,0,0,0,0,0,0,0,0,0,0,0,0,0,0,0,0,0,0,0,0,0,0,0,0,0,0,0
2015,6,94,9431,PAPUA,MAMBERAMO TENGAH,0,0,0,0,0,0,0,0,0,0,0,0,0,0,0,0,0,0,0,0,0,0,0,0,0,0,0,0,0,0,0,0
2015,6,94,9432,PAPUA,YALIMO,0,0,0,0,0,0,0,0,0,0,0,0,0,0,0,0,0,0,0,0,0,0,0,0,0,0,0,0,0,0,0,0
2015,6,94,9433,PAPUA,PUNCAK,0,0,0,0,0,0,0,0,0,0,0,0,0,0,0,0,0,0,0,0,0,0,0,0,0,0,0,0,0,0,0,0
2015,6,94,9434,PAPUA,DOGIYAI,0,0,0,0,0,0,0,0,0,0,0,0,0,0,0,0,0,0,0,0,0,0,0,0,0,0,0,0,0,0,0,0
2015,6,94,9435,PAPUA,INTAN JAYA,0,0,0,0,0,0,0,0,0,0,0,0,0,0,0,0,0,0,0,0,0,0,0,0,0,0,0,0,0,0,0,0
2015,6,94,9436,PAPUA,DEIYAI,0,0,0,0,0,0,0,0,0,0,0,0,0,0,0,0,0,0,0,0,0,0,0,0,0,0,0,0,0,0,0,0
2015,7,91,9171,PAPUA BARAT,KOTA SORONG,1173,1009,539,470,0,2,2,2,3,3,5,3,4,12,12,0,0,9,8,7,24,0,0,22,20,0,6,0,22,26,48,48
2015,7,91,9107,PAPUA BARAT,SORONG,296,299,72,227,0,0,0,0,2,1,4,1,0,11,4,0,0,2,5,1,15,0,0,6,7,0,10,0,13,10,23,23
2015,7,91,9106,PAPUA BARAT,SORONG SELATAN,1366,1366,995,371,0,8,14,29,41,34,33,23,50,80,67,0,0,92,67,73,147,0,0,76,311,0,0,0,174,205,379,387
2015,7,91,9108,PAPUA BARAT,RAJA AMPAT,100,98,50,48,0,1,1,4,4,4,2,5,1,5,0,0,0,10,6,6,5,0,0,2,23,0,2,0,19,8,27,27
2015,7,91,9105,PAPUA BARAT,MANOKWARI,1786,1562,1461,101,0,22,24,118,73,22,34,14,11,99,105,0,0,237,56,25,204,0,0,115,46,0,9,0,275,247,522,170
2015,7,91,9104,PAPUA BARAT,TELUK BINTUNI,392,659,392,267,0,0,0,0,0,0,0,0,0,1,1,0,0,0,0,0,2,0,0,1,2,0,0,0,1,1,2,3
2015,7,91,9103,PAPUA BARAT,TELUK WONDAMA,1109,1109,1084,25,0,38,26,108,129,81,116,117,92,153,157,0,0,301,197,209,310,0,36,120,127,0,7,0,497,520,1017,254
2015,7,91,9101,PAPUA BARAT,FAKFAK,1867,1872,1798,74,0,22,13,75,41,42,25,9,11,69,66,0,0,151,67,20,135,0,0,46,90,0,5,0,217,156,373,141
2015,7,91,9102,PAPUA BARAT,KAIMANA,332,332,289,43,0,0,0,0,1,0,3,0,4,6,8,0,0,1,3,4,14,0,0,4,18,0,0,0,6,16,22,22
2015,7,91,9109,PAPUA BARAT,TAMBRAUW,0,0,0,0,0,0,0,0,0,0,0,0,0,0,0,0,0,0,0,0,0,0,0,0,0,0,0,0,0,0,0,0
2015,7,91,9110,PAPUA BARAT,MAYBRAT,0,0,0,0,0,0,0,0,0,0,0,0,0,0,0,0,0,0,0,0,0,0,0,0,0,0,0,0,0,0,0,0
2015,7,91,9112,PAPUA BARAT,PEGUNUNGAN ARFAK,369,356,356,0,0,3,4,13,10,8,11,8,5,35,44,0,0,30,19,13,79,0,0,52,89,0,0,0,67,74,141,141
2015,7,91,9111,PAPUA BARAT,MANOKWARI SELATAN,0,0,0,0,0,0,0,0,0,0,0,0,0,0,0,0,0,0,0,0,0,0,0,0,0,0,0,0,0,0,0,0
2015,7,94,9403,PAPUA,JAYAPURA,4878,4878,4337,541,0,24,42,149,153,155,155,102,100,431,518,0,0,368,310,202,949,0,5,1202,541,6,80,0,861,968,1829,1829
2015,7,94,9471,PAPUA,KOTA JAYAPURA,3870,3870,3751,119,0,14,5,48,47,59,59,41,45,190,151,0,0,114,118,86,341,0,11,427,205,4,34,0,352,307,659,670
2015,7,94,9420,PAPUA,KEEROM,2585,2585,2033,552,0,6,2,53,58,98,69,64,66,320,277,0,0,119,167,130,597,0,0,717,266,0,50,0,541,472,1013,1033
2015,7,94,9419,PAPUA,SARMI,502,412,241,171,0,4,1,21,25,16,29,18,16,62,58,0,0,51,45,34,120,0,0,111,99,0,50,0,121,129,250,260
2015,7,94,9409,PAPUA,BIAK NUMFOR,1287,1279,1076,203,0,3,2,4,8,9,4,6,8,20,39,0,0,17,13,14,59,0,0,36,56,0,17,0,42,61,103,109
2015,7,94,9427,PAPUA,SUPIORI,338,338,300,38,0,9,5,19,22,7,12,2,1,42,57,0,0,55,19,3,99,0,0,56,116,0,3,0,79,97,176,175
2015,7,94,9401,PAPUA,MERAUKE,0,355,158,197,0,11,11,40,43,48,33,17,10,125,72,0,0,105,81,27,197,0,0,51,205,0,0,0,241,169,410,256
2015,7,94,9414,PAPUA,MAPPI,0,0,0,0,0,0,0,0,0,0,0,0,0,0,0,0,0,0,0,0,0,0,0,0,0,0,0,0,0,0,0,0
2015,7,94,9413,PAPUA,BOVEN DIGOEL,339,339,313,26,0,3,2,20,21,12,14,1,1,22,45,0,0,46,26,2,67,0,0,89,51,0,1,0,58,83,141,141
2015,7,94,9404,PAPUA,NABIRE,3748,3748,3535,213,0,45,20,86,83,69,67,50,44,342,284,0,0,234,136,94,626,0,0,691,423,0,24,0,592,498,1090,1138
2015,7,94,9408,PAPUA,KEPULAUAN YAPEN,36,36,0,36,0,0,0,1,0,1,1,2,1,2,3,0,0,1,2,3,5,0,17,4,3,0,4,0,6,5,11,11
2015,7,94,9412,PAPUA,MIMIKA,11936,12060,11270,790,0,63,47,251,231,272,240,199,160,1480,1339,0,0,592,512,359,2819,0,0,2225,1701,146,130,0,2265,2017,4282,4202
2015,7,94,9410,PAPUA,PANIAI,373,0,0,0,0,0,0,0,0,0,0,0,0,0,0,0,0,0,0,0,0,0,0,0,0,0,0,0,0,0,0,0
2015,7,94,9415,PAPUA,ASMAT,826,826,0,826,0,14,10,44,29,17,24,13,4,73,32,0,0,97,41,17,105,0,0,152,55,0,54,0,161,99,260,261
2015,7,94,9426,PAPUA,WAROPEN,0,0,0,0,0,0,0,0,0,0,0,0,0,0,0,0,0,0,0,0,0,0,0,0,0,0,0,0,0,0,0,0
2015,7,94,9402,PAPUA,JAYAWIJAYA,145,145,129,16,0,0,0,0,0,2,0,0,1,6,4,0,0,0,2,1,10,0,0,8,5,0,0,0,8,5,13,13
2015,7,94,9411,PAPUA,PUNCAK JAYA,0,0,0,0,0,20,26,27,53,76,88,90,116,145,156,0,0,126,164,206,301,0,0,6,8,3,0,0,358,439,797,17
2015,7,94,9418,PAPUA,TOLIKARA,135,135,93,42,0,2,1,3,3,7,5,8,6,20,22,0,0,9,12,14,42,0,0,55,25,0,0,0,40,37,77,80
2015,7,94,9416,PAPUA,YAHUKIMO,0,0,0,0,0,0,0,0,0,0,0,0,0,0,0,0,0,0,0,0,0,0,0,0,0,0,0,0,0,0,0,0
2015,7,94,9417,PAPUA,PEGUNUNGAN BINTANG,0,0,0,0,0,0,0,0,0,0,0,0,0,0,0,0,0,0,0,0,0,0,0,0,0,0,0,0,0,0,0,0
2015,7,94,9428,PAPUA,MAMBERAMO RAYA,160,105,0,105,0,0,1,4,4,1,0,1,1,12,6,0,0,9,1,2,18,0,0,14,5,0,11,0,18,12,30,30
2015,7,94,9429,PAPUA,NDUGA,0,0,0,0,0,0,0,0,0,0,0,0,0,0,0,0,0,0,0,0,0,0,0,0,0,0,0,0,0,0,0,0
2015,7,94,9430,PAPUA,LANNY JAYA,41,12,12,0,0,0,0,0,0,0,0,0,0,2,1,0,0,0,0,0,3,0,0,2,1,0,0,0,2,1,3,3
2015,7,94,9431,PAPUA,MAMBERAMO TENGAH,0,0,0,0,0,0,0,0,0,0,0,0,0,0,0,0,0,0,0,0,0,0,0,0,0,0,0,0,0,0,0,0
2015,7,94,9432,PAPUA,YALIMO,0,0,0,0,0,0,0,0,0,0,0,0,0,0,0,0,0,0,0,0,0,0,0,0,0,0,0,0,0,0,0,0
2015,7,94,9433,PAPUA,PUNCAK,0,0,0,0,0,0,0,0,0,0,0,0,0,0,0,0,0,0,0,0,0,0,0,0,0,0,0,0,0,0,0,0
2015,7,94,9434,PAPUA,DOGIYAI,0,0,0,0,0,0,0,0,0,0,0,0,0,0,0,0,0,0,0,0,0,0,0,0,0,0,0,0,0,0,0,0
2015,7,94,9435,PAPUA,INTAN JAYA,0,0,0,0,0,0,0,0,0,0,0,0,0,0,0,0,0,0,0,0,0,0,0,0,0,0,0,0,0,0,0,0
2015,7,94,9436,PAPUA,DEIYAI,417,417,13,404,0,0,0,0,0,0,0,0,0,0,0,0,0,0,0,0,0,0,0,221,223,0,2,0,0,0,0,446
2015,8,91,9171,PAPUA BARAT,KOTA SORONG,1831,1367,410,957,0,2,4,12,8,7,5,9,6,15,18,0,0,26,12,15,33,0,0,49,32,0,5,0,45,41,86,86
2015,8,91,9107,PAPUA BARAT,SORONG,282,286,132,154,0,0,0,2,0,7,1,2,5,2,2,0,0,2,8,7,4,0,0,5,6,0,11,0,13,8,21,22
2015,8,91,9106,PAPUA BARAT,SORONG SELATAN,954,954,543,411,0,4,1,16,17,14,9,1,6,23,41,0,0,38,23,7,64,0,7,35,13,75,2,0,58,74,132,125
2015,8,91,9108,PAPUA BARAT,RAJA AMPAT,85,85,0,85,0,0,1,5,7,6,6,9,4,12,3,0,0,13,12,13,15,0,0,13,35,0,5,0,32,21,53,53
2015,8,91,9105,PAPUA BARAT,MANOKWARI,2488,2162,1897,265,0,34,27,102,93,52,45,38,30,81,125,0,0,256,97,68,206,0,0,150,474,0,5,0,307,320,627,629
2015,8,91,9104,PAPUA BARAT,TELUK BINTUNI,391,679,391,288,0,0,1,1,0,0,0,0,0,1,0,0,0,2,0,0,1,0,0,0,2,0,0,0,2,1,3,2
2015,8,91,9103,PAPUA BARAT,TELUK WONDAMA,1217,1242,1217,25,0,15,12,51,40,41,34,11,31,45,67,0,0,118,75,42,112,0,0,193,147,0,7,0,163,184,347,347
2015,8,91,9101,PAPUA BARAT,FAKFAK,2165,2165,2090,75,0,18,16,81,67,40,36,6,10,59,51,0,0,182,76,16,110,0,29,385,13,0,2,0,204,180,384,400
2015,8,91,9102,PAPUA BARAT,KAIMANA,405,405,390,15,0,0,0,0,1,3,2,1,0,9,3,0,0,1,5,1,12,0,0,3,14,0,2,0,13,6,19,19
2015,8,91,9109,PAPUA BARAT,TAMBRAUW,93,93,0,93,0,0,1,2,2,0,2,0,1,49,26,0,0,5,2,1,75,0,0,53,35,0,5,0,51,32,83,93
2015,8,91,9110,PAPUA BARAT,MAYBRAT,0,0,0,0,0,0,0,0,0,0,0,0,0,0,0,0,0,0,0,0,0,0,0,0,0,0,0,0,0,0,0,0
2015,8,91,9112,PAPUA BARAT,PEGUNUNGAN ARFAK,595,573,573,0,0,10,8,27,31,15,12,16,14,49,50,0,0,76,27,30,99,0,0,82,153,0,0,0,117,115,232,235
2015,8,91,9111,PAPUA BARAT,MANOKWARI SELATAN,0,0,0,0,0,0,0,0,0,0,0,0,0,0,0,0,0,0,0,0,0,0,0,0,0,0,0,0,0,0,0,0
2015,8,94,9403,PAPUA,JAYAPURA,6352,6352,5675,677,0,21,14,167,177,192,170,145,136,562,446,0,0,379,362,281,1008,0,0,1417,460,19,134,0,1087,943,2030,2030
2015,8,94,9471,PAPUA,KOTA JAYAPURA,6636,6636,5883,753,0,14,8,99,66,78,80,69,58,561,321,0,0,187,158,127,882,0,7,828,459,12,68,0,821,533,1354,1367
2015,8,94,9420,PAPUA,KEEROM,4837,4837,3475,1362,0,7,11,157,129,190,160,151,132,633,615,0,0,304,350,283,1248,0,14,1405,511,0,269,0,1138,1047,2185,2185
2015,8,94,9419,PAPUA,SARMI,257,227,159,68,0,2,2,36,16,20,15,11,8,62,34,0,0,56,35,19,96,0,9,104,44,0,58,0,131,75,206,206
2015,8,94,9409,PAPUA,BIAK NUMFOR,1401,1386,1215,171,0,3,1,17,8,7,5,5,4,17,40,0,0,29,12,9,57,0,0,5,99,0,3,0,49,58,107,107
2015,8,94,9427,PAPUA,SUPIORI,429,429,374,55,0,2,0,14,15,11,2,7,2,39,33,0,0,31,13,9,72,0,0,58,65,0,1,0,73,52,125,124
2015,8,94,9401,PAPUA,MERAUKE,0,0,0,0,0,0,0,0,0,0,0,0,0,0,0,0,0,0,0,0,0,0,0,0,0,0,0,0,0,0,0,0
2015,8,94,9414,PAPUA,MAPPI,0,0,0,0,0,0,0,0,0,0,0,0,0,0,0,0,0,0,0,0,0,0,0,0,0,0,0,0,0,0,0,0
2015,8,94,9413,PAPUA,BOVEN DIGOEL,97,97,0,97,0,0,0,0,8,3,2,4,8,4,8,0,0,8,5,12,12,0,0,20,17,0,7,0,11,26,37,44
2015,8,94,9404,PAPUA,NABIRE,0,0,0,0,0,0,0,0,0,0,0,0,0,0,0,0,0,0,0,0,0,0,0,0,0,0,0,0,0,0,0,0
2015,8,94,9408,PAPUA,KEPULAUAN YAPEN,0,52,21,31,0,0,0,3,3,0,1,1,2,2,8,0,0,6,1,3,10,0,3,17,2,0,1,0,6,14,20,20
2015,8,94,9412,PAPUA,MIMIKA,12118,5189,2809,2380,0,34,26,270,250,252,236,250,199,1306,1249,0,0,580,488,449,2555,0,35,1961,1763,107,116,0,2112,1960,4072,3947
2015,8,94,9410,PAPUA,PANIAI,0,0,0,0,0,0,0,0,0,0,0,0,0,0,0,0,0,0,0,0,0,0,0,0,0,0,0,0,0,0,0,0
2015,8,94,9415,PAPUA,ASMAT,0,364,296,68,0,8,4,22,23,15,18,8,7,45,25,0,0,57,33,15,70,0,0,81,79,1,14,0,98,77,175,175
2015,8,94,9426,PAPUA,WAROPEN,0,0,0,0,0,0,0,0,0,0,0,0,0,0,0,0,0,0,0,0,0,0,0,0,0,0,0,0,0,0,0,0
2015,8,94,9402,PAPUA,JAYAWIJAYA,0,0,0,0,0,0,0,0,0,0,0,0,0,0,0,0,0,0,0,0,0,0,0,0,0,0,0,0,0,0,0,0
2015,8,94,9411,PAPUA,PUNCAK JAYA,0,0,0,0,0,0,0,0,0,0,0,0,0,0,0,0,0,0,0,0,0,0,0,0,0,0,0,0,0,0,0,0
2015,8,94,9418,PAPUA,TOLIKARA,0,0,0,0,0,0,0,0,0,0,0,0,0,0,0,0,0,0,0,0,0,0,0,0,0,0,0,0,0,0,0,0
2015,8,94,9416,PAPUA,YAHUKIMO,0,0,0,0,0,0,0,0,0,0,0,0,0,0,0,0,0,0,0,0,0,0,0,0,0,0,0,0,0,0,0,0
2015,8,94,9417,PAPUA,PEGUNUNGAN BINTANG,0,0,0,0,0,0,0,0,0,0,0,0,0,0,0,0,0,0,0,0,0,0,0,0,0,0,0,0,0,0,0,0
2015,8,94,9428,PAPUA,MAMBERAMO RAYA,27,104,0,104,0,1,1,6,2,3,3,1,1,12,3,0,0,10,6,2,15,0,0,14,4,0,13,0,23,10,33,31
2015,8,94,9429,PAPUA,NDUGA,0,0,0,0,0,0,0,0,0,0,0,0,0,0,0,0,0,0,0,0,0,0,0,0,0,0,0,0,0,0,0,0
2015,8,94,9430,PAPUA,LANNY JAYA,27,16,15,1,0,0,0,0,0,0,0,0,0,1,1,0,0,0,0,0,2,0,0,1,1,0,0,0,1,1,2,2
2015,8,94,9431,PAPUA,MAMBERAMO TENGAH,0,0,0,0,0,0,0,0,0,0,0,0,0,0,0,0,0,0,0,0,0,0,0,0,0,0,0,0,0,0,0,0
2015,8,94,9432,PAPUA,YALIMO,0,0,0,0,0,0,0,0,0,0,0,0,0,0,0,0,0,0,0,0,0,0,0,0,0,0,0,0,0,0,0,0
2015,8,94,9433,PAPUA,PUNCAK,0,0,0,0,0,0,0,0,0,0,0,0,0,0,0,0,0,0,0,0,0,0,0,0,0,0,0,0,0,0,0,0
2015,8,94,9434,PAPUA,DOGIYAI,0,0,0,0,0,0,0,0,0,0,0,0,0,0,0,0,0,0,0,0,0,0,0,0,0,0,0,0,0,0,0,0
2015,8,94,9435,PAPUA,INTAN JAYA,0,0,0,0,0,0,0,0,0,0,0,0,0,0,0,0,0,0,0,0,0,0,0,0,0,0,0,0,0,0,0,0
2015,8,94,9436,PAPUA,DEIYAI,566,566,0,566,0,0,0,46,49,72,74,79,76,79,91,0,0,95,146,155,170,0,0,323,234,0,0,0,276,290,566,557
2015,9,91,9171,PAPUA BARAT,KOTA SORONG,2015,1514,741,773,0,2,4,11,9,5,7,6,4,20,48,0,0,26,12,10,68,0,0,38,39,0,5,0,44,72,116,82
2015,9,91,9107,PAPUA BARAT,SORONG,205,205,142,63,0,0,0,1,0,2,1,0,0,2,3,0,0,1,3,0,5,0,0,3,6,0,0,0,5,4,9,9
2015,9,91,9106,PAPUA BARAT,SORONG SELATAN,596,596,446,150,0,2,4,18,18,13,5,2,7,10,21,0,0,42,18,9,31,0,0,5,81,0,12,0,45,55,100,98
2015,9,91,9108,PAPUA BARAT,RAJA AMPAT,62,62,51,11,0,0,0,1,0,0,2,0,0,5,9,0,0,1,2,0,14,0,0,8,7,0,2,0,6,11,17,17
2015,9,91,9105,PAPUA BARAT,MANOKWARI,866,620,551,69,0,40,22,120,112,49,46,16,25,94,130,0,0,294,95,41,224,0,0,219,486,0,3,0,319,335,654,708
2015,9,91,9104,PAPUA BARAT,TELUK BINTUNI,84,173,84,89,0,0,0,0,0,0,0,0,0,3,0,0,0,0,0,0,3,0,0,0,3,0,0,0,3,0,3,3
2015,9,91,9103,PAPUA BARAT,TELUK WONDAMA,54,267,183,84,0,106,64,52,59,50,38,58,80,350,281,0,0,281,88,138,631,0,125,0,0,0,398,0,616,522,1138,398
2015,9,91,9101,PAPUA BARAT,FAKFAK,2287,2287,1402,885,0,21,12,91,68,50,36,7,14,47,56,0,0,192,86,21,103,0,0,389,24,1,1,0,216,186,402,415
2015,9,91,9102,PAPUA BARAT,KAIMANA,530,396,325,71,0,0,0,0,1,0,0,0,1,2,0,0,0,1,0,1,2,0,0,4,0,0,0,0,2,2,4,4
2015,9,91,9109,PAPUA BARAT,TAMBRAUW,0,0,0,0,0,0,0,0,0,0,0,0,0,0,0,0,0,0,0,0,0,0,0,0,0,0,0,0,0,0,0,0
2015,9,91,9110,PAPUA BARAT,MAYBRAT,18,149,22,127,0,0,0,0,0,0,2,2,3,6,0,0,0,0,2,5,6,0,0,4,9,0,0,0,8,5,13,13
2015,9,91,9112,PAPUA BARAT,PEGUNUNGAN ARFAK,339,339,339,0,0,1,0,12,8,6,6,5,0,0,0,0,0,21,12,5,0,0,0,24,14,0,0,0,24,14,38,38
2015,9,91,9111,PAPUA BARAT,MANOKWARI SELATAN,0,0,0,0,0,0,0,0,0,0,0,0,0,0,0,0,0,0,0,0,0,0,0,0,0,0,0,0,0,0,0,0
2015,9,94,9403,PAPUA,JAYAPURA,6405,6405,5607,798,0,17,23,186,166,198,166,129,122,449,389,0,0,392,364,251,838,0,0,1294,406,8,137,0,979,866,1845,1845
2015,9,94,9471,PAPUA,KOTA JAYAPURA,4864,4864,4766,98,0,7,3,58,55,55,45,43,35,218,155,0,0,123,100,78,373,0,12,425,222,12,27,0,381,293,674,686
2015,9,94,9420,PAPUA,KEEROM,3382,3382,2477,905,0,11,16,111,82,133,101,83,75,336,319,0,0,220,234,158,655,0,0,803,246,0,218,0,674,593,1267,1267
2015,9,94,9419,PAPUA,SARMI,0,0,0,0,0,0,0,0,0,0,0,0,0,0,0,0,0,0,0,0,0,0,0,0,0,0,0,0,0,0,0,0
2015,9,94,9409,PAPUA,BIAK NUMFOR,0,0,0,0,0,0,0,0,0,0,0,0,0,0,0,0,0,0,0,0,0,0,0,0,0,0,0,0,0,0,0,0
2015,9,94,9427,PAPUA,SUPIORI,0,0,0,0,0,0,0,0,0,0,0,0,0,0,0,0,0,0,0,0,0,0,0,0,0,0,0,0,0,0,0,0
2015,9,94,9401,PAPUA,MERAUKE,672,564,380,184,0,0,0,0,0,0,0,0,0,0,0,0,0,0,0,0,0,0,0,52,202,0,0,0,0,0,0,254
2015,9,94,9414,PAPUA,MAPPI,0,0,0,0,0,0,0,0,0,0,0,0,0,0,0,0,0,0,0,0,0,0,0,0,0,0,0,0,0,0,0,0
2015,9,94,9413,PAPUA,BOVEN DIGOEL,0,0,0,0,0,0,0,0,0,0,0,0,0,0,0,0,0,0,0,0,0,0,0,0,0,0,0,0,0,0,0,0
2015,9,94,9404,PAPUA,NABIRE,14,0,0,0,0,0,0,1,1,6,9,17,11,60,38,0,0,2,15,28,98,0,9,0,0,0,0,0,84,59,143,0
2015,9,94,9408,PAPUA,KEPULAUAN YAPEN,6,36,27,9,0,0,0,3,11,9,9,10,14,103,131,0,0,14,18,24,234,0,0,35,0,0,1,0,125,165,290,36
2015,9,94,9412,PAPUA,MIMIKA,11206,11196,9137,2059,0,0,0,0,0,0,0,0,0,0,0,0,0,0,0,0,0,0,0,1377,1392,120,168,5,0,0,0,3062
2015,9,94,9410,PAPUA,PANIAI,0,198,167,31,0,0,0,0,0,0,0,0,0,0,0,0,0,0,0,0,0,0,0,182,16,0,0,0,0,0,0,198
2015,9,94,9415,PAPUA,ASMAT,1516,699,203,496,0,0,0,0,0,0,0,0,0,0,0,0,0,0,0,0,0,0,0,259,125,0,91,0,0,0,0,475
2015,9,94,9426,PAPUA,WAROPEN,0,0,0,0,0,0,0,0,0,0,0,0,0,0,0,0,0,0,0,0,0,0,0,0,0,0,0,0,0,0,0,0
2015,9,94,9402,PAPUA,JAYAWIJAYA,0,0,0,0,0,0,0,0,0,0,0,0,0,0,0,0,0,0,0,0,0,0,0,0,0,0,0,0,0,0,0,0
2015,9,94,9411,PAPUA,PUNCAK JAYA,0,0,0,0,0,0,0,0,0,0,0,0,0,0,0,0,0,0,0,0,0,0,0,0,0,0,0,0,0,0,0,0
2015,9,94,9418,PAPUA,TOLIKARA,0,0,0,0,0,0,0,0,0,0,0,0,0,0,0,0,0,0,0,0,0,0,0,0,0,0,0,0,0,0,0,0
2015,9,94,9416,PAPUA,YAHUKIMO,0,0,0,0,0,0,0,0,0,0,0,0,0,0,0,0,0,0,0,0,0,0,0,0,0,0,0,0,0,0,0,0
2015,9,94,9417,PAPUA,PEGUNUNGAN BINTANG,0,0,0,0,0,0,0,0,0,0,0,0,0,0,0,0,0,0,0,0,0,0,0,0,0,0,0,0,0,0,0,0
2015,9,94,9428,PAPUA,MAMBERAMO RAYA,70,84,0,84,0,1,1,1,2,2,4,6,0,14,2,0,0,5,6,6,16,0,0,15,4,0,15,0,24,9,33,34
2015,9,94,9429,PAPUA,NDUGA,123,123,123,0,0,0,0,8,5,6,5,4,0,43,14,0,0,13,11,4,57,0,0,25,26,0,34,0,61,24,85,85
2015,9,94,9430,PAPUA,LANNY JAYA,46,6,6,0,0,0,0,0,0,0,0,0,0,0,0,0,0,0,0,0,0,0,0,0,2,0,1,0,0,0,0,3
2015,9,94,9431,PAPUA,MAMBERAMO TENGAH,0,0,0,0,0,0,0,0,0,0,0,0,0,0,0,0,0,0,0,0,0,0,0,0,0,0,0,0,0,0,0,0
2015,9,94,9432,PAPUA,YALIMO,0,0,0,0,0,0,0,0,0,0,0,0,0,0,0,0,0,0,0,0,0,0,0,0,0,0,0,0,0,0,0,0
2015,9,94,9433,PAPUA,PUNCAK,0,0,0,0,0,0,0,0,0,0,0,0,0,0,0,0,0,0,0,0,0,0,0,0,0,0,0,0,0,0,0,0
2015,9,94,9434,PAPUA,DOGIYAI,0,0,0,0,0,0,0,0,0,0,0,0,0,0,0,0,0,0,0,0,0,0,0,0,0,0,0,0,0,0,0,0
2015,9,94,9435,PAPUA,INTAN JAYA,0,0,0,0,0,0,0,0,0,0,0,0,0,0,0,0,0,0,0,0,0,0,0,0,0,0,0,0,0,0,0,0
2015,9,94,9436,PAPUA,DEIYAI,353,353,0,353,0,0,3,34,39,104,93,53,66,70,76,0,0,76,197,119,146,0,0,437,95,0,0,0,261,277,538,532
2015,10,91,9171,PAPUA BARAT,KOTA SORONG,654,725,473,252,0,4,9,23,25,13,3,6,6,27,46,0,0,61,16,12,73,0,7,7,151,0,0,0,73,89,162,158
2015,10,91,9107,PAPUA BARAT,SORONG,413,413,370,43,0,0,0,1,3,2,0,3,6,11,2,0,0,4,2,9,13,0,0,13,12,0,3,0,17,11,28,28
2015,10,91,9106,PAPUA BARAT,SORONG SELATAN,725,725,473,252,0,4,9,23,25,13,3,6,6,27,46,0,0,61,16,12,73,0,7,7,151,0,0,0,73,89,162,158
2015,10,91,9108,PAPUA BARAT,RAJA AMPAT,82,82,70,12,0,0,0,1,0,0,0,2,4,6,4,0,0,1,0,6,10,0,0,9,6,0,2,0,9,8,17,17
2015,10,91,9105,PAPUA BARAT,MANOKWARI,2510,2513,2060,453,0,23,131,100,40,29,24,20,91,131,61,0,0,294,53,111,192,0,0,148,479,0,1,0,303,347,650,628
2015,10,91,9104,PAPUA BARAT,TELUK BINTUNI,112,112,81,31,0,0,0,0,0,1,0,0,0,1,0,0,0,0,1,0,1,0,0,0,2,0,0,0,2,0,2,2
2015,10,91,9103,PAPUA BARAT,TELUK WONDAMA,234,234,206,28,0,1,0,2,1,4,2,6,9,15,21,0,0,4,6,15,36,0,0,28,31,0,2,0,28,33,61,61
2015,10,91,9101,PAPUA BARAT,FAKFAK,1357,1357,957,400,0,18,12,62,66,45,20,13,11,33,29,0,0,158,65,24,62,0,0,296,16,0,0,0,171,138,309,312
2015,10,91,9102,PAPUA BARAT,KAIMANA,308,298,202,96,0,0,0,1,1,1,0,1,1,2,1,0,0,2,1,2,3,0,0,6,1,0,1,0,5,3,8,8
2015,10,91,9109,PAPUA BARAT,TAMBRAUW,0,0,0,0,0,0,0,0,0,0,0,0,0,0,0,0,0,0,0,0,0,0,0,0,0,0,0,0,0,0,0,0
2015,10,91,9110,PAPUA BARAT,MAYBRAT,9,3,0,3,0,0,0,0,0,0,0,0,0,0,0,0,0,0,0,0,0,0,0,0,0,0,0,0,0,0,0,0
2015,10,91,9112,PAPUA BARAT,PEGUNUNGAN ARFAK,420,420,420,0,0,5,3,9,17,8,11,7,3,28,30,0,0,34,19,10,58,0,0,71,50,0,0,0,57,64,121,121
2015,10,91,9111,PAPUA BARAT,MANOKWARI SELATAN,0,0,0,0,0,0,0,0,0,0,0,0,0,0,0,0,0,0,0,0,0,0,0,0,0,0,0,0,0,0,0,0
2015,10,94,9403,PAPUA,JAYAPURA,3579,3579,3032,547,0,14,11,111,108,92,101,79,61,261,210,0,0,244,193,140,471,0,0,689,268,98,98,0,557,491,1048,1153
2015,10,94,9471,PAPUA,KOTA JAYAPURA,0,0,0,0,0,0,0,0,0,0,0,0,0,0,0,0,0,0,0,0,0,0,0,0,0,0,0,0,0,0,0,0
2015,10,94,9420,PAPUA,KEEROM,4220,4220,3001,1219,0,10,10,119,124,126,96,97,70,488,360,0,0,263,222,167,848,0,0,979,344,23,154,0,840,660,1500,1500
2015,10,94,9419,PAPUA,SARMI,0,0,0,0,0,0,0,0,0,0,0,0,0,0,0,0,0,0,0,0,0,0,0,0,0,0,0,0,0,0,0,0
2015,10,94,9409,PAPUA,BIAK NUMFOR,0,0,0,0,0,0,0,0,0,0,0,0,0,0,0,0,0,0,0,0,0,0,0,0,0,0,0,0,0,0,0,0
2015,10,94,9427,PAPUA,SUPIORI,0,0,0,0,0,0,0,0,0,0,0,0,0,0,0,0,0,0,0,0,0,0,0,0,0,0,0,0,0,0,0,0
2015,10,94,9401,PAPUA,MERAUKE,0,0,0,0,0,0,0,0,0,0,0,0,0,0,0,0,0,0,0,0,0,0,0,0,0,0,0,0,0,0,0,0
2015,10,94,9414,PAPUA,MAPPI,0,0,0,0,0,0,0,0,0,0,0,0,0,0,0,0,0,0,0,0,0,0,0,0,0,0,0,0,0,0,0,0
2015,10,94,9413,PAPUA,BOVEN DIGOEL,504,504,355,149,0,4,5,34,22,18,23,21,18,62,61,0,0,65,41,39,123,0,0,183,82,0,13,0,139,129,268,278
2015,10,94,9404,PAPUA,NABIRE,4929,4929,4517,412,0,21,25,89,81,65,65,49,60,303,259,0,0,216,130,109,562,0,0,450,361,55,23,0,527,490,1017,889
2015,10,94,9408,PAPUA,KEPULAUAN YAPEN,0,0,0,0,0,0,0,0,0,0,0,0,0,0,0,0,0,0,0,0,0,0,0,0,0,0,0,0,0,0,0,0
2015,10,94,9412,PAPUA,MIMIKA,2497,2497,2497,0,0,5,3,30,27,30,23,11,13,130,117,0,0,65,53,24,247,0,0,158,195,32,4,0,206,183,389,389
2015,10,94,9410,PAPUA,PANIAI,369,136,136,0,0,0,0,23,26,6,8,0,1,26,46,0,0,49,14,1,72,0,0,132,4,0,0,0,55,81,136,136
2015,10,94,9415,PAPUA,ASMAT,0,0,0,0,0,0,0,0,0,0,0,0,0,0,0,0,0,0,0,0,0,0,0,0,0,0,0,0,0,0,0,0
2015,10,94,9426,PAPUA,WAROPEN,0,0,0,0,0,0,0,0,0,0,0,0,0,0,0,0,0,0,0,0,0,0,0,0,0,0,0,0,0,0,0,0
2015,10,94,9402,PAPUA,JAYAWIJAYA,0,0,0,0,0,0,0,0,0,0,0,0,0,0,0,0,0,0,0,0,0,0,0,0,0,0,0,0,0,0,0,0
2015,10,94,9411,PAPUA,PUNCAK JAYA,0,0,0,0,0,0,0,0,0,0,0,0,0,0,0,0,0,0,0,0,0,0,0,0,0,0,0,0,0,0,0,0
2015,10,94,9418,PAPUA,TOLIKARA,0,0,0,0,0,0,0,0,0,0,0,0,0,0,0,0,0,0,0,0,0,0,0,0,0,0,0,0,0,0,0,0
2015,10,94,9416,PAPUA,YAHUKIMO,0,0,0,0,0,0,0,0,0,0,0,0,0,0,0,0,0,0,0,0,0,0,0,0,0,0,0,0,0,0,0,0
2015,10,94,9417,PAPUA,PEGUNUNGAN BINTANG,0,0,0,0,0,0,0,0,0,0,0,0,0,0,0,0,0,0,0,0,0,0,0,0,0,0,0,0,0,0,0,0
2015,10,94,9428,PAPUA,MAMBERAMO RAYA,0,0,0,0,0,0,0,0,0,0,0,0,0,0,0,0,0,0,0,0,0,0,0,0,0,0,0,0,0,0,0,0
2015,10,94,9429,PAPUA,NDUGA,117,117,117,0,0,3,0,4,5,3,3,4,1,39,13,0,0,12,6,5,52,0,0,23,24,0,28,0,53,22,75,75
2015,10,94,9430,PAPUA,LANNY JAYA,0,1,1,0,0,0,0,0,0,0,0,0,0,1,0,0,0,0,0,0,1,0,0,0,0,0,1,0,1,0,1,1
2015,10,94,9431,PAPUA,MAMBERAMO TENGAH,0,0,0,0,0,0,0,0,0,0,0,0,0,0,0,0,0,0,0,0,0,0,0,0,0,0,0,0,0,0,0,0
2015,10,94,9432,PAPUA,YALIMO,0,0,0,0,0,0,0,0,0,0,0,0,0,0,0,0,0,0,0,0,0,0,0,0,0,0,0,0,0,0,0,0
2015,10,94,9433,PAPUA,PUNCAK,0,0,0,0,0,0,0,0,0,0,0,0,0,0,0,0,0,0,0,0,0,0,0,0,0,0,0,0,0,0,0,0
2015,10,94,9434,PAPUA,DOGIYAI,0,0,0,0,0,0,0,0,0,0,0,0,0,0,0,0,0,0,0,0,0,0,0,0,0,0,0,0,0,0,0,0
2015,10,94,9435,PAPUA,INTAN JAYA,0,0,0,0,0,0,0,0,0,0,0,0,0,0,0,0,0,0,0,0,0,0,0,0,0,0,0,0,0,0,0,0
2015,10,94,9436,PAPUA,DEIYAI,0,0,0,0,0,0,0,0,0,0,0,0,0,0,0,0,0,0,0,0,0,0,0,0,0,0,0,0,0,0,0,0
2015,11,91,9171,PAPUA BARAT,KOTA SORONG,851,676,359,317,0,1,0,3,2,3,4,1,2,8,11,0,0,6,7,3,19,0,0,15,17,0,3,0,16,19,35,35
2015,11,91,9107,PAPUA BARAT,SORONG,414,414,160,254,0,1,1,2,1,8,3,2,0,9,1,0,0,5,11,2,10,0,0,12,3,0,12,0,22,6,28,27
2015,11,91,9106,PAPUA BARAT,SORONG SELATAN,438,439,271,168,0,4,5,17,10,17,24,7,7,31,40,0,0,36,41,14,71,0,0,74,87,0,1,0,76,86,162,162
2015,11,91,9108,PAPUA BARAT,RAJA AMPAT,92,92,81,11,0,0,0,0,1,0,3,5,2,9,10,0,0,1,3,7,19,0,0,11,18,0,1,0,14,16,30,30
2015,11,91,9105,PAPUA BARAT,MANOKWARI,642,676,604,72,0,18,18,55,63,22,25,4,13,23,47,0,0,154,47,17,70,0,0,9,277,0,2,0,122,166,288,288
2015,11,91,9104,PAPUA BARAT,TELUK BINTUNI,210,210,189,21,0,0,0,0,0,0,0,0,0,1,0,0,0,0,0,0,1,0,0,1,0,0,0,0,1,0,1,1
2015,11,91,9103,PAPUA BARAT,TELUK WONDAMA,327,327,296,31,0,0,1,2,1,4,2,11,9,15,11,0,0,4,6,20,26,0,0,23,32,0,1,0,32,24,56,56
2015,11,91,9101,PAPUA BARAT,FAKFAK,563,563,466,97,0,1,1,3,6,4,5,8,11,15,21,0,0,11,9,19,36,0,0,31,42,0,2,0,31,44,75,75
2015,11,91,9102,PAPUA BARAT,KAIMANA,85,85,74,11,0,0,0,0,0,0,0,0,1,3,4,0,0,0,0,1,7,0,0,2,6,0,0,0,3,5,8,8
2015,11,91,9109,PAPUA BARAT,TAMBRAUW,0,0,0,0,0,0,0,0,0,0,0,0,0,0,0,0,0,0,0,0,0,0,0,0,0,0,0,0,0,0,0,0
2015,11,91,9110,PAPUA BARAT,MAYBRAT,10,10,0,10,0,0,0,3,2,3,0,0,0,2,0,0,0,5,3,0,2,0,0,7,3,0,0,0,8,2,10,10
2015,11,91,9112,PAPUA BARAT,PEGUNUNGAN ARFAK,188,188,188,0,0,1,0,1,1,0,0,3,2,3,9,0,0,3,0,5,12,0,0,13,7,0,0,0,8,12,20,20
2015,11,91,9111,PAPUA BARAT,MANOKWARI SELATAN,0,0,0,0,0,0,0,0,0,0,0,0,0,0,0,0,0,0,0,0,0,0,0,0,0,0,0,0,0,0,0,0
2015,11,94,9403,PAPUA,JAYAPURA,5149,5149,4161,988,0,12,11,181,184,184,166,129,118,503,371,0,0,388,350,247,874,0,0,1257,436,17,149,0,1009,850,1859,1859
2015,11,94,9471,PAPUA,KOTA JAYAPURA,5993,5993,4581,1412,0,4,5,49,57,71,65,42,50,219,202,0,0,115,136,92,421,0,0,474,248,1,61,0,385,379,764,784
2015,11,94,9420,PAPUA,KEEROM,2985,2985,2292,693,0,7,3,57,53,86,71,69,64,350,223,0,0,120,157,133,573,0,14,629,241,0,116,0,569,414,983,986
2015,11,94,9419,PAPUA,SARMI,1604,1541,1389,152,0,8,12,114,109,90,105,53,32,273,175,0,0,243,195,85,448,0,0,479,322,0,120,0,538,433,971,921
2015,11,94,9409,PAPUA,BIAK NUMFOR,1802,1838,1687,151,0,1,0,14,16,15,8,10,5,23,28,0,0,31,23,15,51,0,0,22,91,0,9,0,63,57,120,122
2015,11,94,9427,PAPUA,SUPIORI,145,145,130,15,0,1,2,9,3,2,3,0,1,12,13,0,0,15,5,1,25,0,0,17,28,0,1,0,24,22,46,46
2015,11,94,9401,PAPUA,MERAUKE,109,209,130,79,0,3,2,15,20,11,14,10,9,57,50,0,0,40,25,19,107,0,85,64,116,2,2,0,96,95,191,184
2015,11,94,9414,PAPUA,MAPPI,1426,1385,1226,159,0,2,10,61,43,37,44,15,17,50,83,0,0,116,81,32,133,0,0,282,20,0,74,0,165,197,362,376
2015,11,94,9413,PAPUA,BOVEN DIGOEL,958,958,758,200,0,7,2,35,34,39,31,23,36,160,120,0,0,78,70,59,280,0,0,313,97,0,78,0,264,223,487,488
2015,11,94,9404,PAPUA,NABIRE,5244,5234,4580,654,0,33,31,81,74,78,77,56,78,360,214,0,0,219,155,134,574,0,8,627,398,0,59,0,608,474,1082,1084
2015,11,94,9408,PAPUA,KEPULAUAN YAPEN,0,0,0,0,0,0,0,0,0,0,0,0,0,0,0,0,0,0,0,0,0,0,0,0,0,0,0,0,0,0,0,0
2015,11,94,9412,PAPUA,MIMIKA,5257,9266,7433,1833,0,20,18,195,175,132,122,101,92,877,677,0,0,408,254,193,1554,0,0,970,1282,69,85,0,1325,1084,2409,2406
2015,11,94,9410,PAPUA,PANIAI,0,0,0,0,0,0,0,0,0,0,0,0,0,0,0,0,0,0,0,0,0,0,0,0,0,0,0,0,0,0,0,0
2015,11,94,9415,PAPUA,ASMAT,1314,1107,801,306,0,11,10,57,70,37,40,18,10,145,53,0,0,148,77,28,198,0,0,233,128,0,106,0,268,183,451,467
2015,11,94,9426,PAPUA,WAROPEN,0,0,0,0,0,0,0,0,0,0,0,0,0,0,0,0,0,0,0,0,0,0,0,0,0,0,0,0,0,0,0,0
2015,11,94,9402,PAPUA,JAYAWIJAYA,0,0,0,0,0,0,0,0,0,0,0,1,0,20,9,0,0,0,0,1,29,0,0,14,16,0,0,0,21,9,30,30
2015,11,94,9411,PAPUA,PUNCAK JAYA,0,0,0,0,0,0,0,0,0,0,0,0,0,0,0,0,0,0,0,0,0,0,0,0,0,0,0,0,0,0,0,0
2015,11,94,9418,PAPUA,TOLIKARA,0,0,0,0,0,0,0,0,0,0,0,0,0,0,0,0,0,0,0,0,0,0,0,0,0,0,0,0,0,0,0,0
2015,11,94,9416,PAPUA,YAHUKIMO,0,0,0,0,0,0,0,0,0,0,0,0,0,0,0,0,0,0,0,0,0,0,0,0,0,0,0,0,0,0,0,0
2015,11,94,9417,PAPUA,PEGUNUNGAN BINTANG,0,0,0,0,0,0,0,0,0,0,0,0,0,0,0,0,0,0,0,0,0,0,0,0,0,0,0,0,0,0,0,0
2015,11,94,9428,PAPUA,MAMBERAMO RAYA,0,0,0,0,0,0,0,0,0,0,0,0,0,0,0,0,0,0,0,0,0,0,0,0,0,0,0,0,0,0,0,0
2015,11,94,9429,PAPUA,NDUGA,0,0,0,0,0,0,0,0,0,0,0,0,0,0,0,0,0,0,0,0,0,0,0,0,0,0,0,0,0,0,0,0
2015,11,94,9430,PAPUA,LANNY JAYA,6,6,6,0,0,0,0,0,0,0,0,0,0,1,1,0,0,0,0,0,2,0,0,1,1,0,0,0,1,1,2,2
2015,11,94,9431,PAPUA,MAMBERAMO TENGAH,0,0,0,0,0,0,0,0,0,0,0,0,0,0,0,0,0,0,0,0,0,0,0,0,0,0,0,0,0,0,0,0
2015,11,94,9432,PAPUA,YALIMO,0,0,0,0,0,0,0,0,0,0,0,0,0,0,0,0,0,0,0,0,0,0,0,0,0,0,0,0,0,0,0,0
2015,11,94,9433,PAPUA,PUNCAK,0,0,0,0,0,0,0,0,0,0,0,0,0,0,0,0,0,0,0,0,0,0,0,0,0,0,0,0,0,0,0,0
2015,11,94,9434,PAPUA,DOGIYAI,0,0,0,0,0,0,0,0,0,0,0,0,0,0,0,0,0,0,0,0,0,0,0,0,0,0,0,0,0,0,0,0
2015,11,94,9435,PAPUA,INTAN JAYA,0,0,0,0,0,0,0,0,0,0,0,0,0,0,0,0,0,0,0,0,0,0,0,0,0,0,0,0,0,0,0,0
2015,11,94,9436,PAPUA,DEIYAI,0,0,0,0,0,0,0,0,0,0,0,0,0,0,0,0,0,0,0,0,0,0,0,0,0,0,0,0,0,0,0,0
2015,12,91,9171,PAPUA BARAT,KOTA SORONG,763,763,669,94,0,3,1,4,3,6,2,2,13,11,11,0,0,11,8,15,22,0,0,21,21,0,7,0,26,30,56,49
2015,12,91,9107,PAPUA BARAT,SORONG,267,267,88,179,0,0,0,3,1,0,1,1,2,3,3,0,0,4,1,3,6,0,0,3,7,0,4,0,7,7,14,14
2015,12,91,9106,PAPUA BARAT,SORONG SELATAN,528,528,338,190,0,1,0,5,3,16,8,3,31,45,45,0,0,9,24,34,90,0,2,64,61,0,7,0,70,87,157,132
2015,12,91,9108,PAPUA BARAT,RAJA AMPAT,74,74,63,11,0,0,0,0,0,0,2,3,5,2,2,0,0,0,2,8,4,0,0,4,8,0,1,0,5,9,14,13
2015,12,91,9105,PAPUA BARAT,MANOKWARI,1116,1116,905,211,0,3,2,24,18,17,4,4,55,41,41,0,0,47,21,59,82,0,0,112,56,0,17,0,89,120,209,185
2015,12,91,9104,PAPUA BARAT,TELUK BINTUNI,0,0,0,0,0,0,0,0,0,0,0,0,0,0,0,0,0,0,0,0,0,0,0,0,0,0,0,0,0,0,0,0
2015,12,91,9103,PAPUA BARAT,TELUK WONDAMA,623,623,580,43,0,1,0,2,1,9,11,21,18,28,28,0,0,4,20,39,56,0,0,30,63,0,2,0,61,58,119,95
2015,12,91,9101,PAPUA BARAT,FAKFAK,723,723,672,51,0,0,0,1,3,11,17,24,53,42,42,0,0,4,28,77,84,0,0,67,86,0,3,0,78,115,193,156
2015,12,91,9102,PAPUA BARAT,KAIMANA,110,110,89,21,0,0,0,0,0,0,0,2,0,3,3,0,0,0,0,2,6,0,0,2,4,0,0,0,5,3,8,6
2015,12,91,9109,PAPUA BARAT,TAMBRAUW,0,0,0,0,0,0,0,0,0,0,0,0,0,0,0,0,0,0,0,0,0,0,0,0,0,0,0,0,0,0,0,0
2015,12,91,9110,PAPUA BARAT,MAYBRAT,10,10,0,10,0,0,0,0,0,5,0,0,0,5,5,0,0,0,5,0,10,0,0,6,4,0,0,0,10,5,15,10
2015,12,91,9112,PAPUA BARAT,PEGUNUNGAN ARFAK,402,402,339,63,0,2,1,22,8,10,6,3,23,33,33,0,0,33,16,26,66,0,0,64,52,0,2,0,70,71,141,118
2015,12,91,9111,PAPUA BARAT,MANOKWARI SELATAN,0,0,0,0,0,0,0,0,0,0,0,0,0,0,0,0,0,0,0,0,0,0,0,0,0,0,0,0,0,0,0,0
2015,12,94,9403,PAPUA,JAYAPURA,3427,3427,3111,316,0,22,9,128,108,113,91,73,49,305,247,0,0,267,204,122,552,0,0,857,234,1,53,0,641,504,1145,1145
2015,12,94,9471,PAPUA,KOTA JAYAPURA,6203,6203,4861,1342,0,6,21,43,33,72,77,115,91,192,197,0,0,103,149,206,389,0,0,565,248,0,47,0,428,419,847,860
2015,12,94,9420,PAPUA,KEEROM,2899,2899,2405,494,0,10,7,66,48,67,67,58,51,271,235,0,0,131,134,109,506,0,0,614,169,0,129,0,472,408,880,912
2015,12,94,9419,PAPUA,SARMI,957,967,863,104,0,17,7,108,94,84,84,48,34,252,172,0,0,226,168,82,424,0,0,546,310,0,49,0,509,391,900,905
2015,12,94,9409,PAPUA,BIAK NUMFOR,842,841,792,49,0,0,0,9,3,7,9,5,6,10,19,0,0,12,16,11,29,0,0,10,57,0,1,0,31,37,68,68
2015,12,94,9427,PAPUA,SUPIORI,403,403,376,27,0,1,0,10,13,6,6,1,3,12,15,0,0,24,12,4,27,0,0,17,49,0,2,0,30,37,67,68
2015,12,94,9401,PAPUA,MERAUKE,0,0,0,0,0,0,0,0,0,0,0,0,0,0,0,0,0,0,0,0,0,0,0,0,0,0,0,0,0,0,0,0
2015,12,94,9414,PAPUA,MAPPI,1438,1279,1215,64,0,2,7,18,30,25,15,18,17,71,54,0,0,57,40,35,125,0,0,185,57,0,19,0,134,123,257,261
2015,12,94,9413,PAPUA,BOVEN DIGOEL,778,778,693,85,0,8,7,29,33,34,27,30,20,62,86,0,0,77,61,50,148,0,0,238,73,0,20,0,163,173,336,331
2015,12,94,9404,PAPUA,NABIRE,3426,2941,2941,0,0,23,20,41,38,37,25,29,37,225,167,0,0,122,62,66,392,0,0,359,255,0,29,0,355,287,642,643
2015,12,94,9408,PAPUA,KEPULAUAN YAPEN,0,0,0,0,0,0,0,0,0,0,0,0,0,0,0,0,0,0,0,0,0,0,0,0,0,0,0,0,0,0,0,0
2015,12,94,9412,PAPUA,MIMIKA,3957,6462,4955,1507,0,17,17,150,127,122,105,119,89,973,622,0,0,311,227,208,1595,0,0,905,1251,52,125,0,1381,960,2341,2333
2015,12,94,9410,PAPUA,PANIAI,0,0,0,0,0,0,0,0,0,0,0,0,0,0,0,0,0,0,0,0,0,0,0,0,0,0,0,0,0,0,0,0
2015,12,94,9415,PAPUA,ASMAT,158,152,7,145,0,2,1,8,15,9,6,4,2,26,16,0,0,26,15,6,42,0,0,60,11,0,18,0,49,40,89,89
2015,12,94,9426,PAPUA,WAROPEN,0,0,0,0,0,0,0,0,0,0,0,0,0,0,0,0,0,0,0,0,0,0,0,0,0,0,0,0,0,0,0,0
2015,12,94,9402,PAPUA,JAYAWIJAYA,0,0,0,0,0,0,0,0,0,0,0,0,0,0,0,0,0,0,0,0,0,0,0,0,0,0,0,0,0,0,0,0
2015,12,94,9411,PAPUA,PUNCAK JAYA,0,0,0,0,0,0,0,0,0,0,0,0,0,0,0,0,0,0,0,0,0,0,0,0,0,0,0,0,0,0,0,0
2015,12,94,9418,PAPUA,TOLIKARA,0,0,0,0,0,0,0,0,0,0,0,0,0,0,0,0,0,0,0,0,0,0,0,0,0,0,0,0,0,0,0,0
2015,12,94,9416,PAPUA,YAHUKIMO,0,0,0,0,0,0,0,0,0,0,0,0,0,0,0,0,0,0,0,0,0,0,0,0,0,0,0,0,0,0,0,0
2015,12,94,9417,PAPUA,PEGUNUNGAN BINTANG,0,0,0,0,0,0,0,0,0,0,0,0,0,0,0,0,0,0,0,0,0,0,0,0,0,0,0,0,0,0,0,0
2015,12,94,9428,PAPUA,MAMBERAMO RAYA,0,0,0,0,0,0,0,0,0,0,0,0,0,0,0,0,0,0,0,0,0,0,0,0,0,0,0,0,0,0,0,0
2015,12,94,9429,PAPUA,NDUGA,0,0,0,0,0,0,0,0,0,0,0,0,0,0,0,0,0,0,0,0,0,0,0,0,0,0,0,0,0,0,0,0
2015,12,94,9430,PAPUA,LANNY JAYA,0,0,0,0,0,0,0,0,0,0,0,0,0,0,0,0,0,0,0,0,0,0,0,0,0,0,0,0,0,0,0,0
2015,12,94,9431,PAPUA,MAMBERAMO TENGAH,0,0,0,0,0,0,0,0,0,0,0,0,0,0,0,0,0,0,0,0,0,0,0,0,0,0,0,0,0,0,0,0
2015,12,94,9432,PAPUA,YALIMO,0,0,0,0,0,0,0,0,0,0,0,0,0,0,0,0,0,0,0,0,0,0,0,0,0,0,0,0,0,0,0,0
2015,12,94,9433,PAPUA,PUNCAK,0,0,0,0,0,0,0,0,0,0,0,0,0,0,0,0,0,0,0,0,0,0,0,0,0,0,0,0,0,0,0,0
2015,12,94,9434,PAPUA,DOGIYAI,0,0,0,0,0,0,0,0,0,0,0,0,0,0,0,0,0,0,0,0,0,0,0,0,0,0,0,0,0,0,0,0
2015,12,94,9435,PAPUA,INTAN JAYA,0,0,0,0,0,0,0,0,0,0,0,0,0,0,0,0,0,0,0,0,0,0,0,0,0,0,0,0,0,0,0,0
2015,12,94,9436,PAPUA,DEIYAI,0,0,0,0,0,0,0,0,0,0,0,0,0,0,0,0,0,0,0,0,0,0,0,0,0,0,0,0,0,0,0,0
2016,1,91,9171,PAPUA BARAT,KOTA SORONG,472,485,174,311,0,0,0,0,0,1,2,1,0,6,3,0,0,0,3,1,9,0,1,4,5,0,5,0,8,5,13,14
2016,1,91,9107,PAPUA BARAT,SORONG,275,198,90,108,0,0,0,0,0,1,2,4,0,6,2,0,0,0,3,4,8,0,0,7,6,0,2,0,11,4,15,15
2016,1,91,9106,PAPUA BARAT,SORONG SELATAN,414,550,480,70,0,1,1,4,3,4,5,1,0,8,12,0,0,9,9,1,20,0,7,23,15,0,1,0,18,21,39,39
2016,1,91,9108,PAPUA BARAT,RAJA AMPAT,208,194,15,179,0,0,0,1,0,0,0,0,0,1,1,0,0,1,0,0,2,0,0,1,2,0,0,0,2,1,3,3
2016,1,91,9105,PAPUA BARAT,MANOKWARI,1916,729,685,44,0,19,13,38,24,31,31,23,13,77,49,18,9,94,62,36,126,27,6,94,259,0,14,0,206,139,345,367
2016,1,91,9104,PAPUA BARAT,TELUK BINTUNI,634,937,631,306,0,0,0,1,1,2,0,0,0,3,1,0,0,2,2,0,4,0,0,4,4,0,2,0,6,2,8,10
2016,1,91,9103,PAPUA BARAT,TELUK WONDAMA,1283,1454,1454,0,0,3,2,35,27,20,22,10,10,70,55,2,1,67,42,20,125,3,0,170,93,0,2,0,140,117,257,265
2016,1,91,9101,PAPUA BARAT,FAKFAK,155,305,176,129,0,7,2,7,4,12,10,5,7,8,6,12,17,20,22,12,14,29,0,96,1,0,0,0,51,46,97,97
2016,1,91,9102,PAPUA BARAT,KAIMANA,892,913,731,182,0,1,1,1,3,5,1,3,0,3,2,1,0,6,6,3,5,1,0,12,5,0,4,0,14,7,21,21
2016,1,91,9109,PAPUA BARAT,TAMBRAUW,236,236,0,236,0,0,0,3,10,14,12,3,2,16,7,0,0,13,26,5,23,0,0,6,42,0,19,0,36,31,67,67
2016,1,91,9110,PAPUA BARAT,MAYBRAT,121,125,0,125,0,0,0,0,0,0,0,0,0,1,3,0,0,0,0,0,4,0,1,2,2,0,0,0,1,3,4,4
2016,1,91,9112,PAPUA BARAT,PEGUNUNGAN ARFAK,998,1009,758,251,0,1,1,40,30,18,22,13,5,46,46,4,1,72,40,18,92,5,2,148,71,0,8,0,122,105,227,227
2016,1,91,9111,PAPUA BARAT,MANOKWARI SELATAN,0,0,0,0,0,0,0,0,0,0,0,0,0,0,0,0,0,0,0,0,0,0,0,0,0,0,0,0,0,0,0,0
2016,1,94,9403,PAPUA,JAYAPURA,6320,6323,5947,376,0,17,15,164,176,221,220,171,143,535,523,0,0,372,441,314,1058,0,9,1703,407,13,57,0,1108,1077,2185,2180
2016,1,94,9471,PAPUA,KOTA JAYAPURA,5034,5034,4469,565,0,9,0,59,47,72,67,59,46,285,191,0,0,115,139,105,476,0,15,523,227,13,72,0,484,351,835,835
2016,1,94,9420,PAPUA,KEEROM,4160,4160,3448,712,0,18,14,190,156,225,204,149,128,658,513,0,0,378,429,277,1171,0,0,1346,519,2,393,0,1240,1015,2255,2260
2016,1,94,9419,PAPUA,SARMI,1628,1628,1423,205,0,19,20,135,118,165,145,95,100,373,310,0,0,292,310,195,683,0,0,649,423,0,170,0,787,693,1480,1242
2016,1,94,9409,PAPUA,BIAK NUMFOR,2195,2187,2083,104,0,2,1,9,8,9,7,5,4,21,14,0,0,20,16,9,35,0,0,29,39,0,13,0,46,34,80,81
2016,1,94,9427,PAPUA,SUPIORI,371,255,255,0,0,3,1,15,14,11,5,3,5,26,12,0,0,33,16,8,38,0,0,32,60,0,3,0,58,37,95,95
2016,1,94,9401,PAPUA,MERAUKE,1080,1080,707,373,0,3,4,28,26,25,15,16,16,62,57,0,0,61,40,32,119,0,0,150,90,0,7,0,134,118,252,247
2016,1,94,9414,PAPUA,MAPPI,1855,1855,1494,361,0,4,7,69,51,45,37,11,18,79,66,0,0,131,82,29,145,0,0,260,98,1,28,0,208,179,387,387
2016,1,94,9413,PAPUA,BOVEN DIGOEL,1962,1962,1668,294,0,8,10,80,68,92,64,41,119,293,182,0,0,166,156,160,475,0,2,807,164,0,95,0,514,443,957,1066
2016,1,94,9404,PAPUA,NABIRE,3928,3928,3455,473,0,18,22,72,62,58,60,55,51,238,231,0,0,174,118,106,469,0,20,444,379,0,44,0,441,426,867,867
2016,1,94,9408,PAPUA,KEPULAUAN YAPEN,1191,1191,615,576,0,14,10,52,59,39,34,16,25,118,150,0,0,135,73,41,268,0,6,363,85,0,69,0,239,278,517,517
2016,1,94,9412,PAPUA,MIMIKA,4285,4192,2396,1796,0,15,15,93,90,88,86,79,65,803,522,0,0,213,174,144,1325,0,20,810,894,4,255,0,1078,778,1856,1963
2016,1,94,9410,PAPUA,PANIAI,89,89,89,0,0,8,5,20,13,5,6,2,0,12,18,0,0,46,11,2,30,0,0,89,0,0,0,0,47,42,89,89
2016,1,94,9415,PAPUA,ASMAT,2254,1845,1333,512,0,32,21,142,129,90,87,30,34,239,192,0,0,324,177,64,431,0,0,559,279,7,153,0,533,463,996,998
2016,1,94,9426,PAPUA,WAROPEN,834,834,834,0,0,6,10,28,26,43,35,25,33,76,91,0,0,70,78,58,167,0,0,361,11,0,0,0,178,195,373,372
2016,1,94,9402,PAPUA,JAYAWIJAYA,458,458,379,79,0,0,0,7,6,3,6,2,0,27,17,0,0,13,9,2,44,0,0,50,17,0,1,0,39,29,68,68
2016,1,94,9411,PAPUA,PUNCAK JAYA,0,0,0,0,0,0,0,0,0,0,0,0,0,0,0,0,0,0,0,0,0,0,0,0,0,0,0,0,0,0,0,0
2016,1,94,9428,PAPUA,MAMBERAMO RAYA,0,0,0,0,0,0,0,0,0,0,0,0,0,0,0,0,0,0,0,0,0,0,0,0,0,0,0,0,0,0,0,0
2016,1,94,9432,PAPUA,YALIMO,40,40,0,40,0,3,1,3,4,1,2,0,1,6,10,0,0,11,3,1,16,0,0,12,15,0,3,0,13,18,31,30
2016,1,94,9417,PAPUA,PEGUNUNGAN BINTANG,0,0,0,0,0,0,0,0,0,0,0,0,0,0,0,0,0,0,0,0,0,0,0,0,0,0,0,0,0,0,0,0
2016,1,94,9431,PAPUA,MAMBERAMO TENGAH,0,0,0,0,0,0,0,0,0,0,0,0,0,0,0,0,0,0,0,0,0,0,0,0,0,0,0,0,0,0,0,0
2016,1,94,9429,PAPUA,NDUGA,0,0,0,0,0,0,0,0,0,0,0,0,0,0,0,0,0,0,0,0,0,0,0,0,0,0,0,0,0,0,0,0
2016,1,94,9430,PAPUA,LANNY JAYA,30,16,16,0,0,0,0,0,0,0,0,0,0,1,1,0,0,0,0,0,2,0,0,1,0,0,1,0,1,1,2,2
2016,1,94,9434,PAPUA,DOGIYAI,0,0,0,0,0,0,0,0,0,0,0,0,0,0,0,0,0,0,0,0,0,0,0,0,0,0,0,0,0,0,0,0
2016,1,94,9436,PAPUA,DEIYAI,248,98,0,98,0,2,3,7,4,7,9,9,10,13,9,0,0,16,16,19,22,0,0,66,62,0,3,0,38,35,73,131
2016,1,94,9435,PAPUA,INTAN JAYA,0,0,0,0,0,0,0,0,0,0,0,0,0,0,0,0,0,0,0,0,0,0,0,0,0,0,0,0,0,0,0,0
2016,1,94,9433,PAPUA,PUNCAK,0,0,0,0,0,0,0,0,0,0,0,0,0,0,0,0,0,0,0,0,0,0,0,0,0,0,0,0,0,0,0,0
2016,1,94,9418,PAPUA,TOLIKARA,0,0,0,0,0,0,0,0,0,0,0,0,0,0,0,0,0,0,0,0,0,0,0,0,0,0,0,0,0,0,0,0
2016,1,94,9416,PAPUA,YAHUKIMO,1353,1353,979,374,0,9,8,46,40,46,42,46,51,212,108,0,0,103,88,97,320,0,0,274,316,0,44,0,359,249,608,634
2016,2,91,9171,PAPUA BARAT,KOTA SORONG,345,302,118,184,0,0,0,0,1,1,0,0,0,4,2,0,0,1,1,0,6,0,1,7,4,0,0,0,5,3,8,11
2016,2,91,9107,PAPUA BARAT,SORONG,377,376,107,269,0,0,0,1,1,1,1,3,1,6,3,0,0,2,2,4,9,0,0,5,9,0,3,0,11,6,17,17
2016,2,91,9106,PAPUA BARAT,SORONG SELATAN,339,367,307,60,0,0,0,5,8,6,2,1,5,13,11,0,0,13,8,6,24,0,4,44,5,0,3,0,25,26,51,52
2016,2,91,9108,PAPUA BARAT,RAJA AMPAT,198,198,15,183,0,0,0,0,0,0,0,1,0,5,1,0,0,0,0,1,6,0,1,1,5,0,1,0,6,1,7,7
2016,2,91,9105,PAPUA BARAT,MANOKWARI,1152,732,662,70,0,13,15,43,33,33,17,13,17,63,58,2,0,104,50,30,121,2,13,94,218,0,10,0,167,140,307,322
2016,2,91,9104,PAPUA BARAT,TELUK BINTUNI,746,1065,743,322,0,0,2,2,4,1,2,0,1,16,0,0,0,8,3,1,16,0,0,9,19,0,0,0,19,9,28,28
2016,2,91,9103,PAPUA BARAT,TELUK WONDAMA,1099,1197,1197,0,0,8,2,17,16,18,9,6,4,46,44,2,0,43,27,10,90,2,0,74,98,0,1,0,97,75,172,173
2016,2,91,9101,PAPUA BARAT,FAKFAK,723,743,623,120,0,3,4,7,10,7,5,7,4,11,7,11,1,24,12,11,18,12,1,74,1,0,2,0,46,31,77,77
2016,2,91,9102,PAPUA BARAT,KAIMANA,1677,849,694,155,0,2,0,1,0,6,2,2,0,2,3,0,0,3,8,2,5,0,1,4,2,0,2,0,13,5,18,8
2016,2,91,9109,PAPUA BARAT,TAMBRAUW,324,162,0,162,0,0,1,8,6,4,10,5,2,10,9,0,1,15,14,7,19,1,2,6,19,0,31,0,27,29,56,56
2016,2,91,9110,PAPUA BARAT,MAYBRAT,275,139,0,139,0,0,0,0,1,0,0,0,0,2,0,0,0,1,0,0,2,0,1,1,1,0,1,0,2,1,3,3
2016,2,91,9112,PAPUA BARAT,PEGUNUNGAN ARFAK,1109,1106,1072,34,0,10,0,47,29,28,24,20,16,61,87,6,5,86,52,36,148,11,1,207,115,0,11,0,172,161,333,333
2016,2,91,9111,PAPUA BARAT,MANOKWARI SELATAN,0,0,0,0,0,0,0,0,0,0,0,0,0,0,0,0,0,0,0,0,0,0,1,0,0,0,0,0,0,0,0,0
2016,2,94,9403,PAPUA,JAYAPURA,7230,7230,6976,254,0,21,13,199,224,332,280,230,216,684,680,0,0,457,612,446,1364,0,11,2147,638,20,65,0,1466,1413,2879,2870
2016,2,94,9471,PAPUA,KOTA JAYAPURA,5246,5246,4919,327,0,34,9,79,72,97,63,63,57,414,271,0,0,194,160,120,685,0,15,706,367,15,76,0,687,472,1159,1164
2016,2,94,9420,PAPUA,KEEROM,3963,3963,3572,391,0,13,11,132,104,190,136,127,124,601,458,0,0,260,326,251,1059,0,0,1233,510,1,151,0,1063,833,1896,1895
2016,2,94,9419,PAPUA,SARMI,1725,1725,1531,194,0,15,27,154,128,155,146,76,66,360,268,0,0,324,301,142,628,0,0,831,429,0,128,0,760,635,1395,1388
2016,2,94,9409,PAPUA,BIAK NUMFOR,1849,1058,898,160,0,1,2,11,10,15,16,8,4,12,10,0,0,24,31,12,22,0,0,47,34,0,8,0,47,42,89,89
2016,2,94,9427,PAPUA,SUPIORI,294,195,195,0,0,1,2,8,5,3,4,3,2,17,13,0,0,16,7,5,30,0,0,15,39,0,4,0,32,26,58,58
2016,2,94,9401,PAPUA,MERAUKE,1065,774,294,480,0,4,4,15,12,20,26,14,9,97,69,0,0,35,46,23,166,0,0,121,118,0,1,0,150,120,270,240
2016,2,94,9414,PAPUA,MAPPI,2918,2918,2629,289,0,11,6,64,68,51,45,19,23,77,77,0,0,149,96,42,154,0,0,282,111,0,48,0,222,219,441,441
2016,2,94,9413,PAPUA,BOVEN DIGOEL,1604,1604,685,919,0,18,21,125,107,76,103,47,38,128,168,0,0,271,179,85,296,0,0,442,181,0,220,0,394,437,831,843
2016,2,94,9404,PAPUA,NABIRE,3695,3695,3371,324,0,11,15,63,60,47,79,37,41,282,181,0,0,149,126,78,463,0,2,378,421,1,16,0,440,376,816,816
2016,2,94,9408,PAPUA,KEPULAUAN YAPEN,2161,1998,1325,673,0,15,14,102,105,92,54,49,22,164,313,0,0,236,146,71,477,0,7,779,139,0,83,0,422,508,930,1001
2016,2,94,9412,PAPUA,MIMIKA,5933,5917,3587,2330,0,23,17,130,133,138,132,149,135,986,707,0,0,303,270,284,1693,0,22,993,1343,10,192,0,1426,1124,2550,2538
2016,2,94,9410,PAPUA,PANIAI,158,158,158,0,0,15,14,26,28,13,6,3,3,18,32,0,0,83,19,6,50,0,0,155,3,0,0,0,75,83,158,158
2016,2,94,9415,PAPUA,ASMAT,2419,1119,669,450,0,28,48,133,130,97,75,40,105,241,282,0,0,339,172,145,523,0,0,541,281,3,276,0,539,640,1179,1101
2016,2,94,9426,PAPUA,WAROPEN,828,828,828,0,0,3,6,22,27,27,24,29,26,62,102,0,0,58,51,55,164,0,0,314,13,0,0,0,143,185,328,327
2016,2,94,9402,PAPUA,JAYAWIJAYA,507,507,429,78,0,0,0,7,1,2,1,3,4,37,15,0,0,8,3,7,52,0,0,29,38,0,3,0,49,21,70,70
2016,2,94,9411,PAPUA,PUNCAK JAYA,0,0,0,0,0,0,0,0,0,0,0,0,0,0,0,0,0,0,0,0,0,0,0,0,0,0,0,0,0,0,0,0
2016,2,94,9418,PAPUA,TOLIKARA,0,0,0,0,0,0,0,0,0,0,0,0,0,0,0,0,0,0,0,0,0,0,0,0,0,0,0,0,0,0,0,0
2016,2,94,9416,PAPUA,YAHUKIMO,529,529,492,37,0,2,5,25,27,8,18,13,7,73,39,0,0,59,26,20,112,0,0,141,58,0,9,0,121,96,217,208
2016,2,94,9417,PAPUA,PEGUNUNGAN BINTANG,0,0,0,0,0,0,0,0,0,0,0,0,0,0,0,0,0,0,0,0,0,0,0,0,0,0,0,0,0,0,0,0
2016,2,94,9428,PAPUA,MAMBERAMO RAYA,0,0,0,0,0,0,0,0,0,0,0,0,0,0,0,0,0,0,0,0,0,0,0,0,0,0,0,0,0,0,0,0
2016,2,94,9429,PAPUA,NDUGA,0,0,0,0,0,0,0,0,0,0,0,0,0,0,0,0,0,0,0,0,0,0,0,0,0,0,0,0,0,0,0,0
2016,2,94,9430,PAPUA,LANNY JAYA,41,18,18,0,0,0,0,0,0,0,0,0,1,0,2,0,0,0,0,1,2,0,0,1,0,2,0,0,0,3,3,3
2016,2,94,9431,PAPUA,MAMBERAMO TENGAH,0,0,0,0,0,0,0,0,0,0,0,0,0,0,0,0,0,0,0,0,0,0,0,0,0,0,0,0,0,0,0,0
2016,2,94,9432,PAPUA,YALIMO,248,65,0,65,0,1,4,5,3,5,10,10,7,9,8,0,0,13,15,17,17,0,0,66,62,0,3,0,30,32,62,131
2016,2,94,9433,PAPUA,PUNCAK,0,0,0,0,0,0,0,0,0,0,0,0,0,0,0,0,0,0,0,0,0,0,0,0,0,0,0,0,0,0,0,0
2016,2,94,9434,PAPUA,DOGIYAI,0,0,0,0,0,0,0,0,0,0,0,0,0,0,0,0,0,0,0,0,0,0,0,0,0,0,0,0,0,0,0,0
2016,2,94,9435,PAPUA,INTAN JAYA,0,0,0,0,0,0,0,0,0,0,0,0,0,0,0,0,0,0,0,0,0,0,0,0,0,0,0,0,0,0,0,0
2016,2,94,9436,PAPUA,DEIYAI,1385,1385,1093,292,0,10,10,44,44,37,35,41,41,160,140,0,0,108,72,82,300,0,0,220,274,1,22,0,292,270,562,517
2016,3,91,9171,PAPUA BARAT,KOTA SORONG,792,782,222,560,0,1,0,0,2,6,3,1,2,15,6,0,0,3,9,3,21,0,1,14,18,0,4,0,23,13,36,36
2016,3,91,9107,PAPUA BARAT,SORONG,302,301,99,202,0,0,0,0,2,1,1,1,0,3,1,0,0,2,2,1,4,0,14,3,5,0,1,0,5,4,9,9
2016,3,91,9106,PAPUA BARAT,SORONG SELATAN,527,527,496,31,0,0,3,9,8,3,3,2,2,9,13,0,0,20,6,4,22,0,1,45,7,0,0,0,23,29,52,52
2016,3,91,9108,PAPUA BARAT,RAJA AMPAT,276,259,15,244,0,0,0,0,0,1,1,0,2,7,1,0,0,0,2,2,8,0,0,1,9,0,2,0,8,4,12,12
2016,3,91,9105,PAPUA BARAT,MANOKWARI,1610,1610,1555,55,0,15,12,31,33,27,26,18,12,68,66,6,7,91,53,30,134,13,13,109,210,0,9,0,165,156,321,328
2016,3,91,9104,PAPUA BARAT,TELUK BINTUNI,848,848,523,325,0,0,0,2,1,0,0,0,0,6,0,1,0,3,0,0,6,1,2,6,4,0,0,0,9,1,10,10
2016,3,91,9103,PAPUA BARAT,TELUK WONDAMA,1046,1046,1046,0,0,5,2,25,26,8,18,8,5,41,26,0,0,58,26,13,67,0,0,90,76,0,0,0,87,77,164,166
2016,3,91,9101,PAPUA BARAT,FAKFAK,1009,1009,932,77,0,3,5,7,6,6,11,2,2,12,10,11,13,21,17,4,22,24,3,90,1,0,0,0,41,47,88,91
2016,3,91,9102,PAPUA BARAT,KAIMANA,641,641,564,77,0,1,0,0,0,1,0,0,1,0,6,0,0,1,1,1,6,0,0,0,2,0,0,0,2,7,9,2
2016,3,91,9109,PAPUA BARAT,TAMBRAUW,632,372,224,148,0,0,0,13,13,20,9,11,10,31,14,2,1,26,29,21,45,3,0,66,46,0,12,0,77,47,124,124
2016,3,91,9110,PAPUA BARAT,MAYBRAT,372,134,0,134,0,0,0,0,0,0,1,0,0,2,0,0,0,0,1,0,2,0,0,3,0,0,0,0,2,1,3,3
2016,3,91,9112,PAPUA BARAT,PEGUNUNGAN ARFAK,852,852,826,26,0,4,2,37,23,32,27,18,9,67,59,6,1,66,59,27,126,7,0,203,71,0,14,0,164,121,285,288
2016,3,91,9111,PAPUA BARAT,MANOKWARI SELATAN,0,0,0,0,0,0,0,0,0,0,0,0,0,0,0,0,0,0,0,0,0,0,4,0,0,0,0,0,0,0,0,0
2016,3,94,9403,PAPUA,JAYAPURA,5440,5870,5578,292,0,20,8,184,154,237,188,140,114,202,502,0,0,366,425,254,704,0,7,1372,340,10,51,0,783,966,1749,1773
2016,3,94,9471,PAPUA,KOTA JAYAPURA,3990,3990,3533,457,0,7,8,62,78,98,78,72,54,384,301,0,0,155,176,126,685,0,8,695,371,10,66,0,623,519,1142,1142
2016,3,94,9420,PAPUA,KEEROM,4559,4559,3653,906,0,13,11,137,147,180,140,141,126,687,567,0,0,308,320,267,1254,0,0,1531,454,1,166,0,1158,991,2149,2152
2016,3,94,9419,PAPUA,SARMI,1178,1178,1016,162,0,10,6,86,79,87,76,44,44,279,172,0,0,181,163,88,451,0,2,566,260,0,58,0,506,377,883,884
2016,3,94,9409,PAPUA,BIAK NUMFOR,1694,1694,1417,277,0,0,4,9,14,9,10,4,5,22,24,0,0,27,19,9,46,0,0,61,34,0,6,0,44,57,101,101
2016,3,94,9427,PAPUA,SUPIORI,289,194,194,0,0,1,1,10,8,2,3,4,1,10,10,0,0,20,5,5,20,0,0,16,31,0,3,0,27,23,50,50
2016,3,94,9401,PAPUA,MERAUKE,936,936,718,218,0,10,6,71,52,43,50,29,29,113,92,0,0,139,93,58,205,0,0,214,281,0,0,0,266,229,495,495
2016,3,94,9414,PAPUA,MAPPI,3034,3034,2346,688,0,6,4,32,33,30,42,17,14,42,55,0,0,75,72,31,97,0,0,200,32,0,43,0,127,148,275,275
2016,3,94,9413,PAPUA,BOVEN DIGOEL,1685,1685,827,858,0,27,26,108,98,116,116,47,37,117,138,0,0,259,232,84,255,0,1,470,167,0,193,0,415,415,830,830
2016,3,94,9404,PAPUA,NABIRE,4888,4888,4473,415,0,15,23,84,65,78,65,55,40,244,227,0,0,187,143,95,471,0,3,458,406,0,32,0,476,420,896,896
2016,3,94,9408,PAPUA,KEPULAUAN YAPEN,1704,1500,1085,415,0,31,26,70,85,65,41,23,30,176,218,0,0,212,106,53,394,0,5,611,97,0,57,0,365,400,765,765
2016,3,94,9412,PAPUA,MIMIKA,5821,5623,4327,1296,0,21,28,129,132,206,190,212,180,1156,744,0,0,310,396,392,1900,0,17,1230,1518,15,220,0,1724,1274,2998,2983
2016,3,94,9410,PAPUA,PANIAI,202,202,202,0,0,13,1,38,22,13,21,3,6,31,54,0,0,74,34,9,85,0,0,202,0,0,0,0,98,104,202,202
2016,3,94,9415,PAPUA,ASMAT,1952,1952,1560,392,0,16,22,88,79,64,35,14,21,117,94,0,0,205,99,35,211,0,0,368,82,0,105,0,299,251,550,555
2016,3,94,9426,PAPUA,WAROPEN,830,830,830,0,0,7,6,26,32,31,31,36,33,60,97,0,0,71,62,69,157,0,0,354,15,0,0,0,160,199,359,369
2016,3,94,9402,PAPUA,JAYAWIJAYA,446,446,401,45,0,0,0,1,3,0,0,1,4,34,18,0,0,4,0,5,52,0,0,33,26,0,2,0,36,25,61,61
2016,3,94,9411,PAPUA,PUNCAK JAYA,0,0,0,0,0,0,0,0,0,0,0,0,0,0,0,0,0,0,0,0,0,0,0,0,0,0,0,0,0,0,0,0
2016,3,94,9418,PAPUA,TOLIKARA,0,0,0,0,0,0,0,0,0,0,0,0,0,0,0,0,0,0,0,0,0,0,0,0,0,0,0,0,0,0,0,0
2016,3,94,9416,PAPUA,YAHUKIMO,423,423,381,42,0,6,7,10,10,10,8,10,11,46,32,0,0,33,18,21,78,0,0,75,65,0,8,0,82,68,150,148
2016,3,94,9417,PAPUA,PEGUNUNGAN BINTANG,0,0,0,0,0,0,0,0,0,0,0,0,0,0,0,0,0,0,0,0,0,0,0,0,0,0,0,0,0,0,0,0
2016,3,94,9428,PAPUA,MAMBERAMO RAYA,0,0,0,0,0,0,0,0,0,0,0,0,0,0,0,0,0,0,0,0,0,0,0,0,0,0,0,0,0,0,0,0
2016,3,94,9429,PAPUA,NDUGA,0,0,0,0,0,0,0,0,0,0,0,0,0,0,0,0,0,0,0,0,0,0,0,0,0,0,0,0,0,0,0,0
2016,3,94,9430,PAPUA,LANNY JAYA,50,23,23,0,0,0,0,0,0,0,0,0,0,2,0,0,0,0,0,0,2,0,0,1,0,0,1,0,2,0,2,2
2016,3,94,9431,PAPUA,MAMBERAMO TENGAH,0,0,0,0,0,0,0,0,0,0,0,0,0,0,0,0,0,0,0,0,0,0,0,0,0,0,0,0,0,0,0,0
2016,3,94,9432,PAPUA,YALIMO,0,0,0,0,0,0,0,0,0,0,0,0,0,0,0,0,0,0,0,0,0,0,0,0,0,0,0,0,0,0,0,0
2016,3,94,9433,PAPUA,PUNCAK,0,0,0,0,0,0,0,0,0,0,0,0,0,0,0,0,0,0,0,0,0,0,0,0,0,0,0,0,0,0,0,0
2016,3,94,9434,PAPUA,DOGIYAI,0,0,0,0,0,0,0,0,0,0,0,0,0,0,0,0,0,0,0,0,0,0,0,0,0,0,0,0,0,0,0,0
2016,3,94,9435,PAPUA,INTAN JAYA,62,62,24,38,0,10,0,7,3,4,3,1,1,22,11,0,0,20,7,2,33,0,0,40,1,0,0,0,44,18,62,41
2016,3,94,9436,PAPUA,DEIYAI,1606,1606,1326,280,0,15,9,51,37,36,46,52,41,151,113,0,0,112,82,93,264,0,0,219,269,0,36,0,305,246,551,524
2016,4,91,9171,PAPUA BARAT,KOTA SORONG,695,661,71,590,0,0,0,7,2,0,1,2,1,10,1,0,0,9,1,3,11,0,1,6,20,0,1,0,19,5,24,27
2016,4,91,9107,PAPUA BARAT,SORONG,317,317,111,206,0,0,0,0,4,1,1,0,0,5,1,0,0,4,2,0,6,0,14,5,4,0,3,0,6,6,12,12
2016,4,91,9106,PAPUA BARAT,SORONG SELATAN,511,511,401,110,0,2,0,5,3,2,3,0,0,9,7,0,0,10,5,0,16,0,0,24,7,0,0,0,18,13,31,31
2016,4,91,9108,PAPUA BARAT,RAJA AMPAT,219,207,15,192,0,0,0,0,0,2,0,0,0,2,1,0,0,0,2,0,3,0,1,1,4,0,0,0,4,1,5,5
2016,4,91,9105,PAPUA BARAT,MANOKWARI,1916,0,0,0,0,0,0,0,0,0,0,0,0,0,0,0,0,0,0,0,0,0,0,0,0,0,0,0,0,0,0,0
2016,4,91,9104,PAPUA BARAT,TELUK BINTUNI,511,625,413,212,0,0,0,1,1,0,1,0,0,1,2,0,0,2,1,0,3,0,0,4,1,0,0,0,2,4,6,5
2016,4,91,9103,PAPUA BARAT,TELUK WONDAMA,967,967,952,15,0,5,1,15,11,18,10,6,2,25,28,0,0,32,28,8,53,0,0,97,24,0,0,0,69,52,121,121
2016,4,91,9101,PAPUA BARAT,FAKFAK,824,824,764,60,0,3,3,13,6,8,12,6,4,19,15,15,16,25,20,10,34,31,2,122,0,0,0,0,64,56,120,122
2016,4,91,9102,PAPUA BARAT,KAIMANA,641,571,455,116,0,0,0,2,4,3,1,3,1,7,4,0,0,6,4,4,11,0,0,3,6,0,12,0,15,10,25,21
2016,4,91,9109,PAPUA BARAT,TAMBRAUW,159,153,151,2,0,2,1,4,2,4,1,2,1,11,10,0,0,9,5,3,21,0,0,27,11,0,0,0,23,15,38,38
2016,4,91,9110,PAPUA BARAT,MAYBRAT,32,20,0,20,0,0,0,1,0,0,0,0,0,1,0,0,0,1,0,0,1,0,0,1,1,0,0,0,2,0,2,2
2016,4,91,9112,PAPUA BARAT,PEGUNUNGAN ARFAK,1049,1047,1013,34,0,6,1,32,20,17,14,10,11,71,51,3,0,59,31,21,122,3,1,174,49,0,13,0,139,97,236,236
2016,4,91,9111,PAPUA BARAT,MANOKWARI SELATAN,0,0,0,0,0,0,0,0,0,0,0,0,0,0,0,0,0,0,0,0,0,0,0,0,0,0,0,0,0,0,0,0
2016,4,94,9403,PAPUA,JAYAPURA,5579,5579,5319,260,0,33,13,194,188,255,235,206,177,615,579,0,0,428,490,383,1194,0,0,1909,447,25,119,0,1303,1192,2495,2500
2016,4,94,9471,PAPUA,KOTA JAYAPURA,4392,4392,4018,374,0,8,11,72,73,92,68,70,72,403,289,0,0,164,160,142,692,0,0,653,399,18,88,0,645,513,1158,1158
2016,4,94,9420,PAPUA,KEEROM,4808,4808,4141,667,0,27,16,116,161,228,164,152,111,731,566,0,0,320,392,263,1297,0,0,1608,608,2,212,0,1254,1018,2272,2430
2016,4,94,9419,PAPUA,SARMI,1620,1620,1377,243,0,16,18,153,123,116,103,56,48,371,229,0,0,310,219,104,600,0,6,740,424,0,81,0,712,521,1233,1245
2016,4,94,9409,PAPUA,BIAK NUMFOR,1579,1551,1483,68,0,2,0,8,7,11,4,10,4,15,13,0,0,17,15,14,28,0,0,37,33,0,4,0,46,28,74,74
2016,4,94,9427,PAPUA,SUPIORI,247,155,155,0,0,1,1,8,8,2,1,2,3,9,12,0,0,18,3,5,21,0,0,15,29,0,2,0,22,25,47,46
2016,4,94,9401,PAPUA,MERAUKE,1384,1384,1237,147,0,8,9,44,38,32,35,37,39,84,93,0,0,99,67,76,177,0,0,242,177,0,1,0,205,214,419,420
2016,4,94,9414,PAPUA,MAPPI,2307,2307,2155,152,0,6,25,53,59,42,39,14,24,55,44,0,0,143,81,38,99,0,0,293,37,0,31,0,170,191,361,361
2016,4,94,9413,PAPUA,BOVEN DIGOEL,2004,2004,925,1079,0,18,13,119,119,98,100,44,57,114,149,0,0,269,198,101,263,0,1,436,172,0,219,0,393,438,831,827
2016,4,94,9404,PAPUA,NABIRE,4322,4322,4016,306,0,9,12,69,50,38,35,27,41,205,142,0,0,140,73,68,347,0,14,374,210,0,28,0,348,280,628,612
2016,4,94,9408,PAPUA,KEPULAUAN YAPEN,1773,1598,1319,279,0,32,26,108,77,65,58,24,8,120,268,0,0,243,123,32,388,0,2,649,129,0,38,0,349,437,786,816
2016,4,94,9412,PAPUA,MIMIKA,6528,6528,4660,1868,0,19,10,100,96,123,99,124,107,747,567,0,0,225,222,231,1314,0,0,995,874,6,106,0,1113,879,1992,1981
2016,4,94,9410,PAPUA,PANIAI,528,528,312,216,0,11,11,44,37,22,25,17,19,88,129,0,0,103,47,36,217,0,0,295,108,0,0,0,182,221,403,403
2016,4,94,9415,PAPUA,ASMAT,1583,1514,1110,404,0,12,16,71,75,36,45,30,30,118,73,0,0,174,81,60,191,0,0,321,86,0,81,0,267,239,506,488
2016,4,94,9426,PAPUA,WAROPEN,0,0,0,0,0,0,0,0,0,0,0,0,0,0,0,0,0,0,0,0,0,0,0,0,0,0,0,0,0,0,0,0
2016,4,94,9402,PAPUA,JAYAWIJAYA,610,610,437,173,0,0,1,4,2,2,8,5,1,38,21,0,0,7,10,6,59,0,0,43,35,0,4,0,49,33,82,82
2016,4,94,9411,PAPUA,PUNCAK JAYA,0,0,0,0,0,0,0,0,0,0,0,0,0,0,0,0,0,0,0,0,0,0,0,0,0,0,0,0,0,0,0,0
2016,4,94,9418,PAPUA,TOLIKARA,0,0,0,0,0,0,0,0,0,0,0,0,0,0,0,0,0,0,0,0,0,0,0,0,0,0,0,0,0,0,0,0
2016,4,94,9416,PAPUA,YAHUKIMO,356,356,296,60,0,1,1,13,16,1,7,5,2,25,17,0,0,31,8,7,42,0,0,32,47,6,3,0,45,43,88,88
2016,4,94,9417,PAPUA,PEGUNUNGAN BINTANG,0,0,0,0,0,0,0,0,0,0,0,0,0,0,0,0,0,0,0,0,0,0,0,0,0,0,0,0,0,0,0,0
2016,4,94,9428,PAPUA,MAMBERAMO RAYA,0,0,0,0,0,0,0,0,0,0,0,0,0,0,0,0,0,0,0,0,0,0,0,0,0,0,0,0,0,0,0,0
2016,4,94,9429,PAPUA,NDUGA,0,0,0,0,0,0,0,0,0,0,0,0,0,0,0,0,0,0,0,0,0,0,0,0,0,0,0,0,0,0,0,0
2016,4,94,9430,PAPUA,LANNY JAYA,24,18,18,0,0,0,0,0,0,0,0,0,0,0,2,0,0,0,0,0,2,0,0,2,0,0,0,0,0,2,2,2
2016,4,94,9431,PAPUA,MAMBERAMO TENGAH,0,0,0,0,0,0,0,0,0,0,0,0,0,0,0,0,0,0,0,0,0,0,0,0,0,0,0,0,0,0,0,0
2016,4,94,9432,PAPUA,YALIMO,0,0,0,0,0,0,0,0,0,0,0,0,0,0,0,0,0,0,0,0,0,0,0,0,0,0,0,0,0,0,0,0
2016,4,94,9433,PAPUA,PUNCAK,0,0,0,0,0,0,0,0,0,0,0,0,0,0,0,0,0,0,0,0,0,0,0,0,0,0,0,0,0,0,0,0
2016,4,94,9434,PAPUA,DOGIYAI,0,0,0,0,0,0,0,0,0,0,0,0,0,0,0,0,0,0,0,0,0,0,0,0,0,0,0,0,0,0,0,0
2016,4,94,9435,PAPUA,INTAN JAYA,0,0,0,0,0,0,0,0,0,0,0,0,0,0,0,0,0,0,0,0,0,0,0,0,0,0,0,0,0,0,0,0
2016,4,94,9436,PAPUA,DEIYAI,1411,1411,1210,201,0,9,7,41,30,21,24,41,40,133,88,0,0,87,45,81,221,0,0,226,188,0,31,0,245,189,434,445
2016,5,91,9171,PAPUA BARAT,KOTA SORONG,695,728,228,500,0,1,2,6,5,2,0,1,2,17,7,1,0,14,2,3,24,1,0,10,34,0,2,0,28,16,44,46
2016,5,91,9107,PAPUA BARAT,SORONG,213,216,123,93,0,0,0,3,2,5,2,1,1,9,2,0,1,5,7,2,11,1,0,7,17,0,2,0,18,8,26,26
2016,5,91,9106,PAPUA BARAT,SORONG SELATAN,372,451,260,191,0,0,0,0,0,0,0,0,0,2,0,0,0,0,0,0,2,0,2,5,0,0,0,0,2,0,2,5
2016,5,91,9108,PAPUA BARAT,RAJA AMPAT,208,0,0,0,0,0,0,0,0,0,0,0,0,0,0,0,0,0,0,0,0,0,0,0,0,0,0,0,0,0,0,0
2016,5,91,9105,PAPUA BARAT,MANOKWARI,1916,0,0,0,0,0,0,0,0,0,0,0,0,0,0,0,0,0,0,0,0,0,0,0,0,0,0,0,0,0,0,0
2016,5,91,9104,PAPUA BARAT,TELUK BINTUNI,585,481,311,170,0,0,0,0,0,0,0,0,0,3,0,0,0,0,0,0,3,0,1,0,3,0,0,0,3,0,3,3
2016,5,91,9103,PAPUA BARAT,TELUK WONDAMA,1436,1436,1436,0,0,6,2,21,10,8,9,3,3,19,20,4,3,39,17,6,39,7,0,77,32,0,0,0,61,47,108,109
2016,5,91,9101,PAPUA BARAT,FAKFAK,55,55,15,40,0,0,0,2,1,1,0,0,0,2,3,0,0,3,1,0,5,0,0,9,0,0,0,0,5,4,9,9
2016,5,91,9102,PAPUA BARAT,KAIMANA,551,237,237,0,0,0,1,0,0,0,0,0,0,2,2,0,0,1,0,0,4,0,0,0,1,0,0,0,2,3,5,1
2016,5,91,9109,PAPUA BARAT,TAMBRAUW,236,0,0,0,0,0,0,0,0,0,0,0,0,0,0,0,0,0,0,0,0,0,0,0,0,0,0,0,0,0,0,0
2016,5,91,9110,PAPUA BARAT,MAYBRAT,46,16,0,16,0,0,0,0,0,0,0,0,0,0,0,0,0,0,0,0,0,0,0,0,0,0,0,0,0,0,0,0
2016,5,91,9112,PAPUA BARAT,PEGUNUNGAN ARFAK,876,876,869,7,0,3,2,28,22,15,13,10,12,32,37,3,1,55,28,22,69,4,1,137,34,0,7,0,91,87,178,178
2016,5,91,9111,PAPUA BARAT,MANOKWARI SELATAN,0,0,0,0,0,0,0,0,0,0,0,0,0,0,0,0,0,0,0,0,0,0,1,0,0,0,0,0,0,0,0,0
2016,5,94,9403,PAPUA,JAYAPURA,5726,5726,5289,437,0,20,18,170,199,241,194,168,160,533,471,0,0,407,435,328,1004,0,0,1591,448,22,111,0,1132,1042,2174,2172
2016,5,94,9471,PAPUA,KOTA JAYAPURA,4360,4360,3880,480,0,4,7,87,69,121,96,101,79,435,315,0,0,167,217,180,750,0,14,779,407,24,104,0,748,566,1314,1314
2016,5,94,9420,PAPUA,KEEROM,5315,5315,4465,850,0,20,18,177,145,272,195,195,167,858,729,0,0,360,467,362,1587,0,0,1851,732,4,195,0,1522,1254,2776,2782
2016,5,94,9419,PAPUA,SARMI,405,561,378,183,0,4,6,59,34,50,58,22,22,98,88,0,0,103,108,44,186,0,2,249,134,1,108,0,233,208,441,492
2016,5,94,9409,PAPUA,BIAK NUMFOR,1479,1510,1391,119,0,0,0,9,3,7,7,3,6,13,20,0,0,12,14,9,33,0,0,35,28,0,5,0,32,36,68,68
2016,5,94,9427,PAPUA,SUPIORI,273,184,180,4,0,4,2,10,3,3,7,2,4,13,14,0,0,19,10,6,27,0,1,24,37,0,2,0,32,30,62,63
2016,5,94,9401,PAPUA,MERAUKE,1225,1225,1078,147,0,8,6,33,26,29,51,9,15,53,49,0,0,73,80,24,102,0,0,153,124,0,0,0,132,147,279,277
2016,5,94,9414,PAPUA,MAPPI,1644,1644,1358,286,0,12,2,56,43,40,41,27,16,89,69,0,0,113,81,43,158,0,1,331,42,0,22,0,224,171,395,395
2016,5,94,9413,PAPUA,BOVEN DIGOEL,1430,1430,871,559,0,10,23,128,124,167,135,67,67,190,259,0,0,285,302,134,449,0,5,734,276,0,189,0,562,608,1170,1199
2016,5,94,9404,PAPUA,NABIRE,1167,1167,976,191,0,10,5,27,21,18,15,12,9,99,76,0,0,63,33,21,175,0,6,201,92,0,1,0,166,126,292,294
2016,5,94,9408,PAPUA,KEPULAUAN YAPEN,2484,2324,1751,573,0,42,30,118,123,75,90,45,39,156,326,0,0,313,165,84,482,0,0,846,166,0,32,0,436,608,1044,1044
2016,5,94,9412,PAPUA,MIMIKA,208,208,0,208,0,1,2,16,15,10,9,0,1,16,9,0,0,34,19,1,25,0,0,72,8,0,6,0,43,36,79,86
2016,5,94,9410,PAPUA,PANIAI,131,131,131,0,0,2,4,21,18,8,7,0,2,23,47,0,0,45,15,2,70,0,0,126,5,0,0,0,54,78,132,131
2016,5,94,9415,PAPUA,ASMAT,1117,1001,515,486,0,30,13,92,103,80,68,22,18,119,86,0,0,238,148,40,205,0,0,402,90,0,141,0,343,288,631,633
2016,5,94,9426,PAPUA,WAROPEN,992,992,992,0,0,24,16,44,51,41,39,22,27,120,183,0,0,135,80,49,303,0,0,554,39,0,0,0,251,316,567,593
2016,5,94,9402,PAPUA,JAYAWIJAYA,562,562,474,88,0,1,1,3,2,0,1,2,1,25,17,0,0,7,1,3,42,0,0,28,23,0,2,0,31,22,53,53
2016,5,94,9411,PAPUA,PUNCAK JAYA,0,0,0,0,0,0,0,0,0,0,0,0,0,0,0,0,0,0,0,0,0,0,0,0,0,0,0,0,0,0,0,0
2016,5,94,9418,PAPUA,TOLIKARA,0,0,0,0,0,0,0,0,0,0,0,0,0,0,0,0,0,0,0,0,0,0,0,0,0,0,0,0,0,0,0,0
2016,5,94,9416,PAPUA,YAHUKIMO,152,152,128,24,0,0,0,6,0,1,2,0,0,15,13,0,0,6,3,0,28,0,0,30,10,0,3,0,22,15,37,43
2016,5,94,9417,PAPUA,PEGUNUNGAN BINTANG,0,0,0,0,0,0,0,0,0,0,0,0,0,0,0,0,0,0,0,0,0,0,0,0,0,0,0,0,0,0,0,0
2016,5,94,9428,PAPUA,MAMBERAMO RAYA,0,0,0,0,0,0,0,0,0,0,0,0,0,0,0,0,0,0,0,0,0,0,0,0,0,0,0,0,0,0,0,0
2016,5,94,9429,PAPUA,NDUGA,0,0,0,0,0,0,0,0,0,0,0,0,0,0,0,0,0,0,0,0,0,0,0,0,0,0,0,0,0,0,0,0
2016,5,94,9430,PAPUA,LANNY JAYA,6,0,0,0,0,0,0,0,0,0,0,0,0,0,0,0,0,0,0,0,0,0,0,0,0,0,0,0,0,0,0,0
2016,5,94,9431,PAPUA,MAMBERAMO TENGAH,0,0,0,0,0,0,0,0,0,0,0,0,0,0,0,0,0,0,0,0,0,0,0,0,0,0,0,0,0,0,0,0
2016,5,94,9432,PAPUA,YALIMO,0,0,0,0,0,0,0,0,0,0,0,0,0,0,0,0,0,0,0,0,0,0,0,0,0,0,0,0,0,0,0,0
2016,5,94,9433,PAPUA,PUNCAK,0,0,0,0,0,0,0,0,0,0,0,0,0,0,0,0,0,0,0,0,0,0,0,0,0,0,0,0,0,0,0,0
2016,5,94,9434,PAPUA,DOGIYAI,0,0,0,0,0,0,0,0,0,0,0,0,0,0,0,0,0,0,0,0,0,0,0,0,0,0,0,0,0,0,0,0
2016,5,94,9435,PAPUA,INTAN JAYA,0,0,0,0,0,0,0,0,0,0,0,0,0,0,0,0,0,0,0,0,0,0,0,0,0,0,0,0,0,0,0,0
2016,5,94,9436,PAPUA,DEIYAI,0,0,0,0,0,0,0,0,0,0,0,0,0,0,0,0,0,0,0,0,0,0,0,0,0,0,0,0,0,0,0,0
2016,6,91,9171,PAPUA BARAT,KOTA SORONG,67,452,415,37,0,4,1,16,7,13,11,7,4,56,30,3,0,28,24,11,86,3,0,14,139,0,0,0,99,53,152,153
2016,6,91,9107,PAPUA BARAT,SORONG,220,228,119,109,0,0,0,1,1,4,0,1,1,4,2,0,0,2,4,2,6,0,2,3,10,0,0,0,10,4,14,13
2016,6,91,9106,PAPUA BARAT,SORONG SELATAN,205,547,197,350,0,0,0,0,2,0,0,0,0,5,2,0,0,2,0,0,7,0,1,5,4,0,1,0,5,4,9,10
2016,6,91,9108,PAPUA BARAT,RAJA AMPAT,134,182,12,170,0,1,1,1,0,4,2,1,0,6,3,1,3,3,6,1,9,4,0,1,0,0,0,0,14,9,23,1
2016,6,91,9105,PAPUA BARAT,MANOKWARI,1916,0,0,0,0,0,0,0,0,0,0,0,0,0,0,0,0,0,0,0,0,0,0,0,0,0,0,0,0,0,0,0
2016,6,91,9104,PAPUA BARAT,TELUK BINTUNI,585,574,395,179,0,0,0,0,0,0,0,0,0,4,0,0,0,0,0,0,4,0,0,4,0,0,0,0,4,0,4,4
2016,6,91,9103,PAPUA BARAT,TELUK WONDAMA,1143,1282,1282,0,0,3,3,15,10,10,9,5,8,36,36,6,5,31,19,13,72,11,5,111,35,0,1,0,75,71,146,147
2016,6,91,9101,PAPUA BARAT,FAKFAK,27,44,33,11,0,0,0,0,0,1,0,0,0,3,0,0,0,0,1,0,3,0,0,6,0,0,0,0,4,0,4,6
2016,6,91,9102,PAPUA BARAT,KAIMANA,551,0,0,0,0,0,0,0,0,0,0,0,0,0,0,0,0,0,0,0,0,0,0,0,0,0,0,0,0,0,0,0
2016,6,91,9109,PAPUA BARAT,TAMBRAUW,236,0,0,0,0,0,0,0,0,0,0,0,0,0,0,0,0,0,0,0,0,0,0,0,0,0,0,0,0,0,0,0
2016,6,91,9110,PAPUA BARAT,MAYBRAT,99,82,0,82,0,0,0,1,1,0,0,1,0,3,1,0,0,2,0,1,4,0,0,2,5,0,0,0,5,2,7,7
2016,6,91,9112,PAPUA BARAT,PEGUNUNGAN ARFAK,876,826,804,22,0,1,4,10,7,7,12,5,3,36,24,2,0,22,19,8,60,2,0,89,15,0,7,0,61,50,111,111
2016,6,91,9111,PAPUA BARAT,MANOKWARI SELATAN,0,0,0,0,0,0,0,0,0,0,0,0,0,0,0,0,0,0,0,0,0,0,0,0,0,0,0,0,0,0,0,0
2016,6,94,9403,PAPUA,JAYAPURA,5564,5564,5146,418,0,21,30,141,146,182,159,146,136,528,403,0,0,338,341,282,931,0,0,1234,527,2,110,0,1018,874,1892,1873
2016,6,94,9471,PAPUA,KOTA JAYAPURA,4236,4236,3727,509,0,6,4,83,86,86,94,82,52,417,311,0,0,179,180,134,728,0,2,739,396,7,79,0,674,547,1221,1221
2016,6,94,9420,PAPUA,KEEROM,3604,3604,2824,780,0,13,17,186,164,270,207,170,166,862,644,0,0,380,477,336,1506,0,0,1768,696,4,232,0,1501,1198,2699,2700
2016,6,94,9419,PAPUA,SARMI,1303,1303,992,311,0,13,14,95,120,107,96,67,49,331,188,0,0,242,203,116,519,0,0,693,291,0,78,0,613,467,1080,1062
2016,6,94,9409,PAPUA,BIAK NUMFOR,1541,1554,1448,106,0,1,1,14,6,10,7,5,3,17,22,0,0,22,17,8,39,0,0,40,43,0,3,0,47,39,86,86
2016,6,94,9427,PAPUA,SUPIORI,291,215,162,53,0,2,1,6,7,5,3,2,1,16,19,0,0,16,8,3,35,0,1,24,40,0,1,0,31,31,62,65
2016,6,94,9401,PAPUA,MERAUKE,909,909,831,78,0,4,2,21,19,16,20,12,14,22,20,0,0,46,36,26,42,0,0,45,105,0,0,0,75,75,150,150
2016,6,94,9414,PAPUA,MAPPI,2170,2170,2064,106,0,3,5,62,59,53,46,21,20,94,57,0,0,129,99,41,151,0,1,322,53,0,45,0,233,187,420,420
2016,6,94,9413,PAPUA,BOVEN DIGOEL,1140,1140,603,537,0,11,10,125,102,124,113,54,62,194,195,0,0,248,237,116,389,0,5,565,285,0,143,0,508,482,990,993
2016,6,94,9404,PAPUA,NABIRE,0,2263,1950,313,0,5,2,26,23,24,14,3,7,70,77,0,0,56,38,10,147,0,3,212,45,17,1,0,128,123,251,275
2016,6,94,9408,PAPUA,KEPULAUAN YAPEN,1844,1827,1398,429,0,54,36,126,135,87,79,46,47,196,422,0,0,351,166,93,618,0,0,994,201,0,33,0,509,719,1228,1228
2016,6,94,9412,PAPUA,MIMIKA,8081,8081,5540,2541,0,17,24,247,191,298,227,185,158,1911,1203,0,0,479,525,343,3114,0,0,2620,2288,15,148,0,2658,1803,4461,5071
2016,6,94,9410,PAPUA,PANIAI,165,165,124,41,0,2,5,22,24,5,9,7,7,31,57,0,0,53,14,14,88,0,0,162,7,0,0,0,67,102,169,169
2016,6,94,9415,PAPUA,ASMAT,317,317,19,298,0,17,15,43,37,17,12,7,2,28,20,0,0,112,29,9,48,0,0,51,50,0,97,0,112,86,198,198
2016,6,94,9426,PAPUA,WAROPEN,0,0,0,0,0,0,0,0,0,0,0,0,0,0,0,0,0,0,0,0,0,0,0,0,0,0,0,0,0,0,0,0
2016,6,94,9402,PAPUA,JAYAWIJAYA,573,573,201,372,0,1,2,2,1,3,0,0,0,26,16,0,0,6,3,0,42,0,1,19,30,0,2,0,32,19,51,51
2016,6,94,9411,PAPUA,PUNCAK JAYA,0,0,0,0,0,0,0,0,0,0,0,0,0,0,0,0,0,0,0,0,0,0,0,0,0,0,0,0,0,0,0,0
2016,6,94,9418,PAPUA,TOLIKARA,0,0,0,0,0,0,0,0,0,0,0,0,0,0,0,0,0,0,0,0,0,0,0,0,0,0,0,0,0,0,0,0
2016,6,94,9416,PAPUA,YAHUKIMO,309,309,245,64,0,2,2,5,4,9,2,0,1,21,8,0,0,13,11,1,29,0,0,32,25,0,7,0,37,17,54,64
2016,6,94,9417,PAPUA,PEGUNUNGAN BINTANG,0,0,0,0,0,0,0,0,0,0,0,0,0,0,0,0,0,0,0,0,0,0,0,0,0,0,0,0,0,0,0,0
2016,6,94,9428,PAPUA,MAMBERAMO RAYA,0,0,0,0,0,0,0,0,0,0,0,0,0,0,0,0,0,0,0,0,0,0,0,0,0,0,0,0,0,0,0,0
2016,6,94,9429,PAPUA,NDUGA,0,0,0,0,0,0,0,0,0,0,0,0,0,0,0,0,0,0,0,0,0,0,0,0,0,0,0,0,0,0,0,0
2016,6,94,9430,PAPUA,LANNY JAYA,0,0,0,0,0,0,0,0,0,0,0,0,0,0,0,0,0,0,0,0,0,0,0,0,0,0,0,0,0,0,0,0
2016,6,94,9431,PAPUA,MAMBERAMO TENGAH,0,0,0,0,0,0,0,0,0,0,0,0,0,0,0,0,0,0,0,0,0,0,0,0,0,0,0,0,0,0,0,0
2016,6,94,9432,PAPUA,YALIMO,0,0,0,0,0,0,0,0,0,0,0,0,0,0,0,0,0,0,0,0,0,0,0,0,0,0,0,0,0,0,0,0
2016,6,94,9433,PAPUA,PUNCAK,0,0,0,0,0,0,0,0,0,0,0,0,0,0,0,0,0,0,0,0,0,0,0,0,0,0,0,0,0,0,0,0
2016,6,94,9434,PAPUA,DOGIYAI,0,0,0,0,0,0,0,0,0,0,0,0,0,0,0,0,0,0,0,0,0,0,0,0,0,0,0,0,0,0,0,0
2016,6,94,9435,PAPUA,INTAN JAYA,61,61,51,10,0,0,2,9,6,10,10,3,3,21,8,0,0,17,20,6,29,0,0,73,1,0,9,0,43,29,72,83
2016,6,94,9436,PAPUA,DEIYAI,0,0,0,0,0,0,0,0,0,0,0,0,0,0,0,0,0,0,0,0,0,0,0,0,0,0,0,0,0,0,0,0
2016,7,91,9171,PAPUA BARAT,KOTA SORONG,45,35,24,11,0,0,2,4,5,5,5,8,1,21,12,2,0,11,10,9,33,2,0,1,1,0,0,0,40,25,65,2
2016,7,91,9107,PAPUA BARAT,SORONG,284,275,210,65,0,0,0,0,0,3,0,0,0,0,0,1,0,0,3,0,0,1,0,1,3,0,0,0,4,0,4,4
2016,7,91,9106,PAPUA BARAT,SORONG SELATAN,208,313,188,125,0,0,0,0,0,1,0,0,0,1,1,0,0,0,1,0,2,0,1,1,0,0,0,0,2,1,3,1
2016,7,91,9108,PAPUA BARAT,RAJA AMPAT,189,221,14,207,0,0,0,3,1,0,1,1,1,3,3,0,0,4,1,2,6,0,0,2,2,0,0,0,7,6,13,4
2016,7,91,9105,PAPUA BARAT,MANOKWARI,1916,0,0,0,0,0,0,0,0,0,0,0,0,0,0,0,0,0,0,0,0,0,0,0,0,0,0,0,0,0,0,0
2016,7,91,9104,PAPUA BARAT,TELUK BINTUNI,585,0,0,0,0,0,0,0,0,0,0,0,0,0,0,0,0,0,0,0,0,0,0,0,0,0,0,0,0,0,0,0
2016,7,91,9103,PAPUA BARAT,TELUK WONDAMA,936,1038,1038,0,0,8,2,19,12,11,8,4,2,27,18,2,1,41,19,6,45,3,5,95,19,0,1,0,71,43,114,115
2016,7,91,9101,PAPUA BARAT,FAKFAK,38,40,24,16,0,0,0,0,0,0,0,0,0,2,1,0,0,0,0,0,3,0,2,2,1,0,0,0,2,1,3,3
2016,7,91,9102,PAPUA BARAT,KAIMANA,551,0,0,0,0,0,0,0,0,0,0,0,0,0,0,0,0,0,0,0,0,0,0,0,0,0,0,0,0,0,0,0
2016,7,91,9109,PAPUA BARAT,TAMBRAUW,236,0,0,0,0,0,0,0,0,0,0,0,0,0,0,0,0,0,0,0,0,0,0,0,0,0,0,0,0,0,0,0
2016,7,91,9110,PAPUA BARAT,MAYBRAT,99,82,0,82,0,0,0,1,1,0,0,1,0,3,1,0,0,2,0,1,4,0,0,2,5,0,0,0,5,2,7,7
2016,7,91,9112,PAPUA BARAT,PEGUNUNGAN ARFAK,876,0,0,0,0,0,0,0,0,0,0,0,0,0,0,0,0,0,0,0,0,0,0,0,0,0,0,0,0,0,0,0
2016,7,91,9111,PAPUA BARAT,MANOKWARI SELATAN,0,0,0,0,0,0,0,4,13,6,5,4,4,12,19,0,0,17,11,8,31,0,0,0,0,0,0,0,26,41,67,0
2016,7,94,9403,PAPUA,JAYAPURA,3228,3228,3005,223,0,6,8,78,106,108,96,84,58,242,226,0,0,198,204,142,468,0,2,639,288,12,70,0,518,494,1012,1009
2016,7,94,9471,PAPUA,KOTA JAYAPURA,3779,3779,3396,383,0,2,3,61,51,77,57,57,41,319,242,0,0,117,134,98,561,0,0,575,289,8,38,0,516,394,910,910
2016,7,94,9420,PAPUA,KEEROM,1902,1902,1245,657,0,10,21,145,106,199,164,133,103,531,488,0,0,282,363,236,1019,0,0,1159,475,3,261,0,1018,882,1900,1898
2016,7,94,9419,PAPUA,SARMI,513,513,361,152,0,5,3,56,48,35,50,8,22,93,78,0,0,112,85,30,171,0,19,203,113,0,62,0,197,201,398,378
2016,7,94,9409,PAPUA,BIAK NUMFOR,1289,926,795,131,0,1,2,7,10,6,6,10,5,20,17,0,0,20,12,15,37,0,1,43,44,0,5,0,44,40,84,92
2016,7,94,9427,PAPUA,SUPIORI,237,175,175,0,0,2,1,5,3,2,3,2,0,15,5,0,0,11,5,2,20,0,0,5,32,0,2,0,26,12,38,39
2016,7,94,9401,PAPUA,MERAUKE,546,546,487,59,0,1,4,17,16,15,13,9,7,30,29,0,0,38,28,16,59,0,1,51,88,0,3,0,72,69,141,142
2016,7,94,9414,PAPUA,MAPPI,1833,1833,1637,196,0,4,5,53,44,51,41,18,18,76,62,0,0,106,92,36,138,0,0,282,39,0,51,0,202,170,372,372
2016,7,94,9413,PAPUA,BOVEN DIGOEL,844,844,444,400,0,13,5,82,81,79,67,35,34,128,104,0,0,181,146,69,232,0,0,335,144,0,144,0,337,291,628,623
2016,7,94,9404,PAPUA,NABIRE,0,0,0,0,0,0,0,0,0,0,0,0,0,0,0,0,0,0,0,0,0,0,0,0,0,0,0,0,0,0,0,0
2016,7,94,9408,PAPUA,KEPULAUAN YAPEN,3078,3078,2392,686,0,43,34,149,132,105,98,47,49,191,402,0,0,358,203,96,593,0,26,989,223,0,38,0,535,715,1250,1250
2016,7,94,9412,PAPUA,MIMIKA,9633,9633,7286,2347,0,17,36,220,196,245,234,230,194,1733,1205,0,0,469,479,424,2938,0,0,1605,910,45,237,0,2445,1865,4310,2797
2016,7,94,9410,PAPUA,PANIAI,153,153,153,0,0,3,2,10,6,5,7,4,2,13,20,0,0,21,12,6,33,0,0,55,17,0,0,0,35,37,72,72
2016,7,94,9415,PAPUA,ASMAT,112,109,20,89,0,3,8,20,7,12,3,1,4,26,14,0,0,38,15,5,40,0,0,31,26,0,41,0,62,36,98,98
2016,7,94,9426,PAPUA,WAROPEN,0,0,0,0,0,0,0,0,0,0,0,0,0,0,0,0,0,0,0,0,0,0,0,0,0,0,0,0,0,0,0,0
2016,7,94,9402,PAPUA,JAYAWIJAYA,455,455,336,119,0,0,1,2,4,2,3,3,1,21,8,0,0,7,5,4,29,0,0,31,13,0,1,0,28,17,45,45
2016,7,94,9411,PAPUA,PUNCAK JAYA,0,0,0,0,0,0,0,0,0,0,0,0,0,0,0,0,0,0,0,0,0,0,0,0,0,0,0,0,0,0,0,0
2016,7,94,9418,PAPUA,TOLIKARA,0,0,0,0,0,0,0,0,0,0,0,0,0,0,0,0,0,0,0,0,0,0,0,0,0,0,0,0,0,0,0,0
2016,7,94,9416,PAPUA,YAHUKIMO,379,379,336,43,0,4,3,14,14,5,3,6,5,63,22,0,0,35,8,11,85,0,0,72,63,0,4,0,92,47,139,139
2016,7,94,9417,PAPUA,PEGUNUNGAN BINTANG,0,0,0,0,0,0,0,0,0,0,0,0,0,0,0,0,0,0,0,0,0,0,0,0,0,0,0,0,0,0,0,0
2016,7,94,9428,PAPUA,MAMBERAMO RAYA,0,0,0,0,0,0,0,0,0,0,0,0,0,0,0,0,0,0,0,0,0,0,0,0,0,0,0,0,0,0,0,0
2016,7,94,9429,PAPUA,NDUGA,0,0,0,0,0,0,0,0,0,0,0,0,0,0,0,0,0,0,0,0,0,0,0,0,0,0,0,0,0,0,0,0
2016,7,94,9430,PAPUA,LANNY JAYA,0,0,0,0,0,0,0,0,0,0,0,0,0,0,0,0,0,0,0,0,0,0,0,0,0,0,0,0,0,0,0,0
2016,7,94,9431,PAPUA,MAMBERAMO TENGAH,0,0,0,0,0,0,0,0,0,0,0,0,0,0,0,0,0,0,0,0,0,0,0,0,0,0,0,0,0,0,0,0
2016,7,94,9432,PAPUA,YALIMO,0,0,0,0,0,0,0,0,0,0,0,0,0,0,0,0,0,0,0,0,0,0,0,0,0,0,0,0,0,0,0,0
2016,7,94,9433,PAPUA,PUNCAK,0,0,0,0,0,0,0,0,0,0,0,0,0,0,0,0,0,0,0,0,0,0,0,0,0,0,0,0,0,0,0,0
2016,7,94,9434,PAPUA,DOGIYAI,0,0,0,0,0,0,0,0,0,0,0,0,0,0,0,0,0,0,0,0,0,0,0,0,0,0,0,0,0,0,0,0
2016,7,94,9435,PAPUA,INTAN JAYA,0,0,0,0,0,0,2,9,6,10,10,3,3,21,8,0,0,17,20,6,29,0,0,0,0,0,0,0,43,29,72,0
2016,7,94,9436,PAPUA,DEIYAI,0,0,0,0,0,0,0,0,0,0,0,0,0,0,0,0,0,0,0,0,0,0,0,0,0,0,0,0,0,0,0,0
2016,8,91,9171,PAPUA BARAT,KOTA SORONG,0,0,0,0,0,2,3,13,10,8,8,2,6,23,35,2,2,28,16,8,58,4,0,0,0,0,0,0,50,64,114,0
2016,8,91,9107,PAPUA BARAT,SORONG,353,323,247,76,0,1,1,0,0,0,0,0,0,3,1,0,0,2,0,0,4,0,0,5,1,0,0,0,4,2,6,6
2016,8,91,9106,PAPUA BARAT,SORONG SELATAN,418,0,0,0,0,0,0,1,0,1,1,0,0,2,3,0,0,1,2,0,5,0,0,0,0,0,0,0,4,4,8,0
2016,8,91,9108,PAPUA BARAT,RAJA AMPAT,199,213,15,198,0,0,0,1,0,0,0,0,0,2,1,0,0,1,0,0,3,0,0,2,2,0,0,0,3,1,4,4
2016,8,91,9105,PAPUA BARAT,MANOKWARI,1916,0,0,0,0,0,0,0,0,0,0,0,0,0,0,0,0,0,0,0,0,0,0,0,0,0,0,0,0,0,0,0
2016,8,91,9104,PAPUA BARAT,TELUK BINTUNI,585,0,0,0,0,0,0,0,0,0,0,0,0,0,0,0,0,0,0,0,0,0,0,0,0,0,0,0,0,0,0,0
2016,8,91,9103,PAPUA BARAT,TELUK WONDAMA,1198,1621,1338,283,0,2,3,20,24,11,13,8,4,31,23,0,0,49,24,12,54,0,1,113,27,0,0,0,72,67,139,140
2016,8,91,9101,PAPUA BARAT,FAKFAK,365,375,363,12,0,0,0,0,0,0,0,0,0,0,0,0,0,0,0,0,0,0,3,10,0,0,0,0,0,0,0,10
2016,8,91,9102,PAPUA BARAT,KAIMANA,551,0,0,0,0,0,0,0,0,0,0,0,0,0,0,0,0,0,0,0,0,0,0,0,0,0,0,0,0,0,0,0
2016,8,91,9109,PAPUA BARAT,TAMBRAUW,236,0,0,0,0,0,0,0,0,0,0,0,0,0,0,0,0,0,0,0,0,0,0,0,0,0,0,0,0,0,0,0
2016,8,91,9110,PAPUA BARAT,MAYBRAT,0,0,0,0,0,0,0,0,0,0,0,0,0,0,0,0,0,0,0,0,0,0,0,0,0,0,0,0,0,0,0,0
2016,8,91,9112,PAPUA BARAT,PEGUNUNGAN ARFAK,876,0,0,0,0,0,0,0,0,0,0,0,0,0,0,0,0,0,0,0,0,0,0,0,0,0,0,0,0,0,0,0
2016,8,91,9111,PAPUA BARAT,MANOKWARI SELATAN,0,0,0,0,0,2,0,9,10,8,5,5,3,39,13,1,0,21,13,8,52,1,0,0,0,0,0,0,64,31,95,0
2016,8,94,9403,PAPUA,JAYAPURA,4139,4139,3767,372,0,15,11,82,77,104,121,88,78,239,249,0,0,185,225,166,488,0,0,724,259,15,66,0,528,536,1064,1064
2016,8,94,9471,PAPUA,KOTA JAYAPURA,4638,4638,4078,560,0,30,10,89,72,96,107,76,51,439,312,0,0,201,203,127,751,0,0,738,418,15,111,0,730,552,1282,1282
2016,8,94,9420,PAPUA,KEEROM,2585,2585,1943,642,0,26,21,175,140,244,217,167,163,755,673,0,0,362,461,330,1428,0,0,1586,656,4,339,0,1367,1214,2581,2585
2016,8,94,9419,PAPUA,SARMI,440,399,315,84,0,2,0,26,27,31,39,18,9,86,61,0,0,55,70,27,147,0,3,136,92,0,45,0,163,136,299,273
2016,8,94,9409,PAPUA,BIAK NUMFOR,2022,2006,1797,209,0,3,1,7,10,10,13,9,4,27,20,0,0,21,23,13,47,0,0,60,34,0,10,0,56,48,104,104
2016,8,94,9427,PAPUA,SUPIORI,242,178,178,0,0,0,4,3,3,2,2,0,3,7,4,0,0,10,4,3,11,0,0,19,6,0,3,0,12,16,28,28
2016,8,94,9401,PAPUA,MERAUKE,943,943,809,134,0,3,1,17,12,24,11,16,11,43,49,0,0,33,35,27,92,0,0,76,126,0,1,0,103,84,187,203
2016,8,94,9414,PAPUA,MAPPI,1533,1533,1410,123,0,6,4,50,31,39,46,14,9,73,46,0,0,91,85,23,119,0,0,228,40,0,50,0,182,136,318,318
2016,8,94,9413,PAPUA,BOVEN DIGOEL,1018,1018,569,449,0,10,18,101,104,89,76,36,24,107,140,0,0,233,165,60,247,0,0,409,194,0,103,0,343,362,705,706
2016,8,94,9404,PAPUA,NABIRE,0,0,0,0,0,0,0,0,0,0,0,0,0,0,0,0,0,0,0,0,0,0,0,0,0,0,0,0,0,0,0,0
2016,8,94,9408,PAPUA,KEPULAUAN YAPEN,1152,1120,634,486,0,16,11,52,41,35,41,18,22,81,141,0,0,120,76,40,222,0,0,388,50,0,20,0,202,256,458,458
2016,8,94,9412,PAPUA,MIMIKA,12787,12787,9903,2884,0,26,25,288,264,306,279,250,185,2045,1277,0,0,603,585,435,3322,0,0,2321,1749,143,311,0,2915,2030,4945,4524
2016,8,94,9410,PAPUA,PANIAI,328,328,200,128,0,8,3,34,25,11,14,14,7,39,47,0,0,70,25,21,86,0,0,150,52,0,0,0,106,96,202,202
2016,8,94,9415,PAPUA,ASMAT,404,404,0,404,0,10,13,39,18,17,9,8,0,76,52,0,0,80,26,8,128,0,0,93,71,0,79,0,150,92,242,243
2016,8,94,9426,PAPUA,WAROPEN,0,0,0,0,0,0,0,0,0,0,0,0,0,0,0,0,0,0,0,0,0,0,0,0,0,0,0,0,0,0,0,0
2016,8,94,9402,PAPUA,JAYAWIJAYA,629,629,468,161,0,0,0,5,3,3,2,6,2,21,14,0,0,8,5,8,35,0,0,31,25,0,0,0,35,21,56,56
2016,8,94,9411,PAPUA,PUNCAK JAYA,0,0,0,0,0,0,0,0,0,0,0,0,0,0,0,0,0,0,0,0,0,0,0,0,0,0,0,0,0,0,0,0
2016,8,94,9418,PAPUA,TOLIKARA,0,0,0,0,0,0,0,0,0,0,0,0,0,0,0,0,0,0,0,0,0,0,0,0,0,0,0,0,0,0,0,0
2016,8,94,9416,PAPUA,YAHUKIMO,306,306,263,43,0,3,0,10,5,7,9,1,0,32,12,0,0,18,16,1,44,0,0,40,37,0,2,0,53,26,79,79
2016,8,94,9417,PAPUA,PEGUNUNGAN BINTANG,0,0,0,0,0,0,0,0,0,0,0,0,0,0,0,0,0,0,0,0,0,0,0,0,0,0,0,0,0,0,0,0
2016,8,94,9428,PAPUA,MAMBERAMO RAYA,0,0,0,0,0,0,0,0,0,0,0,0,0,0,0,0,0,0,0,0,0,0,0,0,0,0,0,0,0,0,0,0
2016,8,94,9429,PAPUA,NDUGA,0,0,0,0,0,0,0,0,0,0,0,0,0,0,0,0,0,0,0,0,0,0,0,0,0,0,0,0,0,0,0,0
2016,8,94,9430,PAPUA,LANNY JAYA,0,0,0,0,0,0,0,0,0,0,0,0,0,0,0,0,0,0,0,0,0,0,0,0,0,0,0,0,0,0,0,0
2016,8,94,9431,PAPUA,MAMBERAMO TENGAH,0,0,0,0,0,0,0,0,0,0,0,0,0,0,0,0,0,0,0,0,0,0,0,0,0,0,0,0,0,0,0,0
2016,8,94,9432,PAPUA,YALIMO,0,0,0,0,0,0,0,0,0,0,0,0,0,0,0,0,0,0,0,0,0,0,0,0,0,0,0,0,0,0,0,0
2016,8,94,9433,PAPUA,PUNCAK,0,0,0,0,0,0,0,0,0,0,0,0,0,0,0,0,0,0,0,0,0,0,0,0,0,0,0,0,0,0,0,0
2016,8,94,9434,PAPUA,DOGIYAI,0,0,0,0,0,0,0,0,0,0,0,0,0,0,0,0,0,0,0,0,0,0,0,0,0,0,0,0,0,0,0,0
2016,8,94,9435,PAPUA,INTAN JAYA,0,0,0,0,0,0,0,0,0,0,0,0,0,0,0,0,0,0,0,0,0,0,0,0,0,0,0,0,0,0,0,0
2016,8,94,9436,PAPUA,DEIYAI,0,0,0,0,0,0,0,0,0,0,0,0,0,0,0,0,0,0,0,0,0,0,0,0,0,0,0,0,0,0,0,0
2016,9,91,9171,PAPUA BARAT,KOTA SORONG,333,361,243,118,0,0,0,2,0,4,2,1,3,5,3,3,2,2,6,4,8,5,0,21,3,0,1,0,15,10,25,25
2016,9,91,9107,PAPUA BARAT,SORONG,274,185,140,45,0,0,0,0,0,0,0,1,1,4,0,0,0,0,0,2,4,0,0,2,2,0,2,0,5,1,6,6
2016,9,91,9106,PAPUA BARAT,SORONG SELATAN,251,64,33,31,0,0,0,0,0,0,1,0,0,1,1,1,2,0,1,0,2,3,0,3,3,0,0,0,2,4,6,6
2016,9,91,9108,PAPUA BARAT,RAJA AMPAT,209,200,16,184,0,0,0,1,0,0,0,0,0,2,1,0,0,1,0,0,3,0,0,2,2,0,0,0,3,1,4,4
2016,9,91,9105,PAPUA BARAT,MANOKWARI,1916,0,0,0,0,0,0,0,0,0,0,0,0,0,0,0,0,0,0,0,0,0,0,0,0,0,0,0,0,0,0,0
2016,9,91,9104,PAPUA BARAT,TELUK BINTUNI,585,493,359,134,0,0,0,2,1,2,1,0,0,5,1,0,0,3,3,0,6,0,0,11,1,0,0,0,9,3,12,12
2016,9,91,9103,PAPUA BARAT,TELUK WONDAMA,1139,1507,1218,289,0,3,3,10,7,13,12,3,3,26,18,0,0,23,25,6,44,0,2,70,29,0,1,0,55,43,98,100
2016,9,91,9101,PAPUA BARAT,FAKFAK,1546,756,678,78,0,3,3,9,4,0,3,2,0,8,8,11,6,19,3,2,16,17,1,57,0,0,0,0,33,24,57,57
2016,9,91,9102,PAPUA BARAT,KAIMANA,551,0,0,0,0,0,0,0,0,0,0,0,0,0,0,0,0,0,0,0,0,0,0,0,0,0,0,0,0,0,0,0
2016,9,91,9109,PAPUA BARAT,TAMBRAUW,236,0,0,0,0,0,0,0,0,0,0,0,0,0,0,0,0,0,0,0,0,0,0,0,0,0,0,0,0,0,0,0
2016,9,91,9110,PAPUA BARAT,MAYBRAT,60,0,0,0,0,0,0,0,0,0,0,0,0,0,0,0,0,0,0,0,0,0,0,0,0,0,0,0,0,0,0,0
2016,9,91,9112,PAPUA BARAT,PEGUNUNGAN ARFAK,779,779,741,38,0,1,5,10,9,10,9,8,4,30,18,0,0,25,19,12,48,0,0,78,14,0,13,0,59,45,104,105
2016,9,91,9111,PAPUA BARAT,MANOKWARI SELATAN,0,0,0,0,0,0,0,0,0,0,0,0,0,0,0,0,0,0,0,0,0,0,0,0,0,0,0,0,0,0,0,0
2016,9,94,9403,PAPUA,JAYAPURA,3828,3828,3553,275,0,6,8,100,92,112,98,84,63,208,202,0,0,206,210,147,410,0,0,588,307,26,52,0,510,463,973,973
2016,9,94,9471,PAPUA,KOTA JAYAPURA,4717,4717,4079,638,0,7,15,80,82,104,71,76,58,444,307,0,0,184,175,134,751,0,22,675,458,17,94,0,711,533,1244,1244
2016,9,94,9420,PAPUA,KEEROM,1658,1658,1240,418,0,13,13,118,98,174,119,104,85,529,403,0,0,242,293,189,932,0,0,985,504,4,164,0,938,718,1656,1657
2016,9,94,9419,PAPUA,SARMI,0,0,0,0,0,0,0,0,0,0,0,0,0,0,0,0,0,0,0,0,0,0,0,0,0,0,0,0,0,0,0,0
2016,9,94,9409,PAPUA,BIAK NUMFOR,1674,1719,1431,288,0,2,0,14,4,8,6,8,1,21,19,0,0,20,14,9,40,0,0,46,22,0,14,0,53,30,83,82
2016,9,94,9427,PAPUA,SUPIORI,209,147,147,0,0,0,0,0,1,0,2,0,1,8,6,0,0,1,2,1,14,0,1,11,4,0,3,0,8,10,18,18
2016,9,94,9401,PAPUA,MERAUKE,1014,877,706,171,0,1,2,18,13,17,15,17,13,48,40,0,0,34,32,30,88,0,0,59,112,4,6,0,101,83,184,181
2016,9,94,9414,PAPUA,MAPPI,1292,1292,1235,57,0,2,0,42,34,29,18,13,10,57,29,0,0,78,47,23,86,0,0,155,46,0,33,0,143,91,234,234
2016,9,94,9413,PAPUA,BOVEN DIGOEL,997,997,687,310,0,7,4,98,91,84,76,39,36,123,137,0,0,200,160,75,260,0,1,407,207,0,82,0,351,344,695,696
2016,9,94,9404,PAPUA,NABIRE,0,0,0,0,0,0,0,0,0,0,0,0,0,0,0,0,0,0,0,0,0,0,0,0,0,0,0,0,0,0,0,0
2016,9,94,9408,PAPUA,KEPULAUAN YAPEN,524,524,241,283,0,13,14,30,37,23,18,13,9,48,86,0,0,94,41,22,134,0,0,223,48,0,20,0,127,164,291,291
2016,9,94,9412,PAPUA,MIMIKA,9493,9493,7936,1557,0,29,26,226,236,298,284,237,203,1654,1254,0,0,517,582,440,2908,0,0,2484,1571,115,284,0,2444,2003,4447,4454
2016,9,94,9410,PAPUA,PANIAI,442,442,171,271,0,5,4,13,17,13,11,14,12,48,49,0,0,39,24,26,97,0,0,145,41,0,0,0,93,93,186,186
2016,9,94,9415,PAPUA,ASMAT,189,189,2,187,0,12,7,31,24,5,10,5,1,38,21,0,0,74,15,6,59,0,0,45,49,0,60,0,91,63,154,154
2016,9,94,9426,PAPUA,WAROPEN,0,0,0,0,0,0,0,0,0,0,0,0,0,0,0,0,0,0,0,0,0,0,0,0,0,0,0,0,0,0,0,0
2016,9,94,9402,PAPUA,JAYAWIJAYA,506,506,335,171,0,0,1,3,1,1,5,2,2,13,11,0,0,5,6,4,24,0,0,22,16,0,1,0,19,20,39,39
2016,9,94,9411,PAPUA,PUNCAK JAYA,0,0,0,0,0,0,0,0,0,0,0,0,0,0,0,0,0,0,0,0,0,0,0,0,0,0,0,0,0,0,0,0
2016,9,94,9418,PAPUA,TOLIKARA,0,0,0,0,0,0,0,0,0,0,0,0,0,0,0,0,0,0,0,0,0,0,0,0,0,0,0,0,0,0,0,0
2016,9,94,9416,PAPUA,YAHUKIMO,302,302,265,37,0,3,1,6,13,5,5,2,1,47,10,0,0,23,10,3,57,0,0,36,44,0,13,0,63,30,93,93
2016,9,94,9417,PAPUA,PEGUNUNGAN BINTANG,0,0,0,0,0,0,0,0,0,0,0,0,0,0,0,0,0,0,0,0,0,0,0,0,0,0,0,0,0,0,0,0
2016,9,94,9428,PAPUA,MAMBERAMO RAYA,0,0,0,0,0,0,0,0,0,0,0,0,0,0,0,0,0,0,0,0,0,0,0,0,0,0,0,0,0,0,0,0
2016,9,94,9429,PAPUA,NDUGA,0,0,0,0,0,0,0,0,0,0,0,0,0,0,0,0,0,0,0,0,0,0,0,0,0,0,0,0,0,0,0,0
2016,9,94,9430,PAPUA,LANNY JAYA,0,0,0,0,0,0,0,0,0,0,0,0,0,0,0,0,0,0,0,0,0,0,0,0,0,0,0,0,0,0,0,0
2016,9,94,9431,PAPUA,MAMBERAMO TENGAH,0,0,0,0,0,0,0,0,0,0,0,0,0,0,0,0,0,0,0,0,0,0,0,0,0,0,0,0,0,0,0,0
2016,9,94,9432,PAPUA,YALIMO,0,0,0,0,0,0,0,0,0,0,0,0,0,0,0,0,0,0,0,0,0,0,0,0,0,0,0,0,0,0,0,0
2016,9,94,9433,PAPUA,PUNCAK,0,0,0,0,0,0,0,0,0,0,0,0,0,0,0,0,0,0,0,0,0,0,0,0,0,0,0,0,0,0,0,0
2016,9,94,9434,PAPUA,DOGIYAI,0,0,0,0,0,0,0,0,0,0,0,0,0,0,0,0,0,0,0,0,0,0,0,0,0,0,0,0,0,0,0,0
2016,9,94,9435,PAPUA,INTAN JAYA,0,0,0,0,0,0,0,0,0,0,0,0,0,0,0,0,0,0,0,0,0,0,0,0,0,0,0,0,0,0,0,0
2016,9,94,9436,PAPUA,DEIYAI,0,0,0,0,0,0,0,0,0,0,0,0,0,0,0,0,0,0,0,0,0,0,0,0,0,0,0,0,0,0,0,0
2016,10,91,9171,PAPUA BARAT,KOTA SORONG,1007,1054,831,223,0,0,1,0,3,4,4,1,1,11,11,3,1,4,8,2,22,4,0,27,8,1,1,0,19,21,40,37
2016,10,91,9107,PAPUA BARAT,SORONG,0,0,0,0,0,0,0,0,0,0,0,0,0,0,0,0,0,0,0,0,0,0,0,0,0,0,0,0,0,0,0,0
2016,10,91,9106,PAPUA BARAT,SORONG SELATAN,299,103,72,31,0,0,0,1,5,6,0,1,4,12,7,0,0,6,6,5,19,0,0,29,4,0,3,0,20,16,36,36
2016,10,91,9108,PAPUA BARAT,RAJA AMPAT,0,0,0,0,0,0,0,0,0,0,0,0,0,0,0,0,0,0,0,0,0,0,0,0,0,0,0,0,0,0,0,0
2016,10,91,9105,PAPUA BARAT,MANOKWARI,0,0,0,0,0,0,0,0,0,0,0,0,0,0,0,0,0,0,0,0,0,0,0,0,0,0,0,0,0,0,0,0
2016,10,91,9104,PAPUA BARAT,TELUK BINTUNI,0,0,0,0,0,0,0,0,0,0,0,0,0,0,0,0,0,0,0,0,0,0,0,0,0,0,0,0,0,0,0,0
2016,10,91,9103,PAPUA BARAT,TELUK WONDAMA,1131,1262,1251,11,0,5,3,18,9,10,14,6,5,41,24,0,1,35,24,11,65,1,1,116,22,0,1,0,80,56,136,139
2016,10,91,9101,PAPUA BARAT,FAKFAK,232,232,208,24,0,0,1,1,1,0,0,0,1,3,1,0,0,3,0,1,4,0,0,6,2,0,0,0,4,4,8,8
2016,10,91,9102,PAPUA BARAT,KAIMANA,0,0,0,0,0,0,0,0,0,0,0,0,0,0,0,0,0,0,0,0,0,0,0,0,0,0,0,0,0,0,0,0
2016,10,91,9109,PAPUA BARAT,TAMBRAUW,0,0,0,0,0,0,0,0,0,0,0,0,0,0,0,0,0,0,0,0,0,0,0,0,0,0,0,0,0,0,0,0
2016,10,91,9110,PAPUA BARAT,MAYBRAT,0,0,0,0,0,0,0,0,0,0,0,0,0,0,0,0,0,0,0,0,0,0,0,0,0,0,0,0,0,0,0,0
2016,10,91,9112,PAPUA BARAT,PEGUNUNGAN ARFAK,773,773,733,40,0,0,1,17,14,9,5,6,2,40,14,2,0,32,14,8,54,2,1,91,10,0,11,0,74,36,110,112
2016,10,91,9111,PAPUA BARAT,MANOKWARI SELATAN,0,0,0,0,0,0,0,0,0,0,0,0,0,0,0,0,0,0,0,0,0,0,0,0,0,0,0,0,0,0,0,0
2016,10,94,9403,PAPUA,JAYAPURA,3922,3922,3766,156,0,10,13,111,120,127,130,85,62,222,231,0,0,254,257,147,453,0,0,756,273,24,58,0,555,556,1111,1111
2016,10,94,9471,PAPUA,KOTA JAYAPURA,5257,5257,4752,505,0,7,6,68,63,102,70,55,60,424,285,0,0,144,172,115,709,0,21,606,436,14,84,0,656,484,1140,1140
2016,10,94,9420,PAPUA,KEEROM,2003,2003,1266,737,0,19,16,137,125,179,187,154,107,609,463,0,0,297,366,261,1072,0,0,1129,581,10,284,0,1098,898,1996,2004
2016,10,94,9419,PAPUA,SARMI,0,0,0,0,0,0,0,0,0,0,0,0,0,0,0,0,0,0,0,0,0,0,0,0,0,0,0,0,0,0,0,0
2016,10,94,9409,PAPUA,BIAK NUMFOR,3875,2577,1538,1039,0,1,0,9,10,4,9,8,4,22,24,0,0,20,13,12,46,0,0,43,32,0,15,0,44,47,91,90
2016,10,94,9427,PAPUA,SUPIORI,251,184,184,0,0,2,1,8,2,4,1,3,0,11,11,0,0,13,5,3,22,0,0,12,32,0,0,0,28,15,43,44
2016,10,94,9401,PAPUA,MERAUKE,1203,915,769,146,0,12,7,33,23,38,22,16,10,60,67,0,0,75,60,26,127,0,0,219,86,0,3,0,159,129,288,308
2016,10,94,9414,PAPUA,MAPPI,1739,1739,1616,123,0,2,3,51,42,44,51,10,10,55,39,0,0,98,95,20,94,0,0,197,78,0,32,0,162,145,307,307
2016,10,94,9413,PAPUA,BOVEN DIGOEL,997,997,663,334,0,15,14,92,74,64,49,26,36,107,141,0,0,195,113,62,248,0,0,352,183,0,83,0,304,314,618,618
2016,10,94,9404,PAPUA,NABIRE,0,0,0,0,0,0,0,0,0,0,0,0,0,0,0,0,0,0,0,0,0,0,0,0,0,0,0,0,0,0,0,0
2016,10,94,9408,PAPUA,KEPULAUAN YAPEN,1074,946,824,122,0,19,8,49,65,41,38,29,28,100,106,0,0,141,79,57,206,0,0,363,95,0,25,0,238,245,483,483
2016,10,94,9412,PAPUA,MIMIKA,10157,10157,7415,2742,0,25,15,249,199,186,240,177,152,1130,933,0,0,488,426,329,2063,0,22,1686,1327,96,222,0,1767,1539,3306,3331
2016,10,94,9410,PAPUA,PANIAI,208,208,95,113,0,2,2,18,31,4,14,11,12,43,54,0,0,53,18,23,97,0,0,124,36,0,0,0,78,113,191,160
2016,10,94,9415,PAPUA,ASMAT,0,0,0,0,0,0,0,0,0,0,0,0,0,0,0,0,0,0,0,0,0,0,0,0,0,0,0,0,0,0,0,0
2016,10,94,9426,PAPUA,WAROPEN,0,0,0,0,0,0,0,0,0,0,0,0,0,0,0,0,0,0,0,0,0,0,0,0,0,0,0,0,0,0,0,0
2016,10,94,9402,PAPUA,JAYAWIJAYA,839,839,467,372,0,0,0,2,1,2,3,1,1,22,20,0,0,3,5,2,42,0,0,29,22,0,1,0,27,25,52,52
2016,10,94,9411,PAPUA,PUNCAK JAYA,0,0,0,0,0,0,0,0,0,0,0,0,0,0,0,0,0,0,0,0,0,0,0,0,0,0,0,0,0,0,0,0
2016,10,94,9418,PAPUA,TOLIKARA,0,0,0,0,0,0,0,0,0,0,0,0,0,0,0,0,0,0,0,0,0,0,0,0,0,0,0,0,0,0,0,0
2016,10,94,9416,PAPUA,YAHUKIMO,285,285,273,12,0,0,0,10,5,1,3,4,1,32,13,0,0,15,4,5,45,0,0,42,23,0,4,0,47,22,69,69
2016,10,94,9417,PAPUA,PEGUNUNGAN BINTANG,0,0,0,0,0,0,0,0,0,0,0,0,0,0,0,0,0,0,0,0,0,0,0,0,0,0,0,0,0,0,0,0
2016,10,94,9428,PAPUA,MAMBERAMO RAYA,0,0,0,0,0,0,0,0,0,0,0,0,0,0,0,0,0,0,0,0,0,0,0,0,0,0,0,0,0,0,0,0
2016,10,94,9429,PAPUA,NDUGA,0,0,0,0,0,0,0,0,0,0,0,0,0,0,0,0,0,0,0,0,0,0,0,0,0,0,0,0,0,0,0,0
2016,10,94,9430,PAPUA,LANNY JAYA,0,0,0,0,0,0,0,0,0,0,0,0,0,0,0,0,0,0,0,0,0,0,0,0,0,0,0,0,0,0,0,0
2016,10,94,9431,PAPUA,MAMBERAMO TENGAH,0,0,0,0,0,0,0,0,0,0,0,0,0,0,0,0,0,0,0,0,0,0,0,0,0,0,0,0,0,0,0,0
2016,10,94,9432,PAPUA,YALIMO,0,0,0,0,0,0,0,0,0,0,0,0,0,0,0,0,0,0,0,0,0,0,0,0,0,0,0,0,0,0,0,0
2016,10,94,9433,PAPUA,PUNCAK,0,0,0,0,0,0,0,0,0,0,0,0,0,0,0,0,0,0,0,0,0,0,0,0,0,0,0,0,0,0,0,0
2016,10,94,9434,PAPUA,DOGIYAI,0,0,0,0,0,0,0,0,0,0,0,0,0,0,0,0,0,0,0,0,0,0,0,0,0,0,0,0,0,0,0,0
2016,10,94,9435,PAPUA,INTAN JAYA,0,0,0,0,0,0,0,0,0,0,0,0,0,0,0,0,0,0,0,0,0,0,0,0,0,0,0,0,0,0,0,0
2016,10,94,9436,PAPUA,DEIYAI,0,0,0,0,0,0,0,0,0,0,0,0,0,0,0,0,0,0,0,0,0,0,0,0,0,0,0,0,0,0,0,0
2016,11,91,9171,PAPUA BARAT,KOTA SORONG,547,903,626,277,0,0,0,3,3,3,0,1,0,8,2,0,0,6,3,1,10,0,1,7,10,0,3,0,15,5,20,20
2016,11,91,9107,PAPUA BARAT,SORONG,0,0,0,0,0,0,0,0,0,0,0,0,0,0,0,0,0,0,0,0,0,0,0,0,0,0,0,0,0,0,0,0
2016,11,91,9106,PAPUA BARAT,SORONG SELATAN,0,0,0,0,0,0,0,0,0,0,0,0,0,0,0,0,0,0,0,0,0,0,0,0,0,0,0,0,0,0,0,0
2016,11,91,9108,PAPUA BARAT,RAJA AMPAT,0,0,0,0,0,0,0,0,0,0,0,0,0,0,0,0,0,0,0,0,0,0,0,0,0,0,0,0,0,0,0,0
2016,11,91,9105,PAPUA BARAT,MANOKWARI,0,0,0,0,0,0,0,0,0,0,0,0,0,0,0,0,0,0,0,0,0,0,0,0,0,0,0,0,0,0,0,0
2016,11,91,9104,PAPUA BARAT,TELUK BINTUNI,0,0,0,0,0,0,0,0,0,0,0,0,0,0,0,0,0,0,0,0,0,0,0,0,0,0,0,0,0,0,0,0
2016,11,91,9103,PAPUA BARAT,TELUK WONDAMA,0,0,0,0,0,0,0,0,0,0,0,0,0,0,0,0,0,0,0,0,0,0,0,0,0,0,0,0,0,0,0,0
2016,11,91,9101,PAPUA BARAT,FAKFAK,0,0,0,0,0,0,0,0,0,0,0,0,0,0,0,0,0,0,0,0,0,0,0,0,0,0,0,0,0,0,0,0
2016,11,91,9102,PAPUA BARAT,KAIMANA,0,0,0,0,0,0,0,0,0,0,0,0,0,0,0,0,0,0,0,0,0,0,0,0,0,0,0,0,0,0,0,0
2016,11,91,9109,PAPUA BARAT,TAMBRAUW,0,0,0,0,0,0,0,0,0,0,0,0,0,0,0,0,0,0,0,0,0,0,0,0,0,0,0,0,0,0,0,0
2016,11,91,9110,PAPUA BARAT,MAYBRAT,0,0,0,0,0,0,0,0,0,0,0,0,0,0,0,0,0,0,0,0,0,0,0,0,0,0,0,0,0,0,0,0
2016,11,91,9112,PAPUA BARAT,PEGUNUNGAN ARFAK,0,0,0,0,0,0,0,0,0,0,0,0,0,0,0,0,0,0,0,0,0,0,0,0,0,0,0,0,0,0,0,0
2016,11,91,9111,PAPUA BARAT,MANOKWARI SELATAN,0,0,0,0,0,0,0,0,0,0,0,0,0,0,0,0,0,0,0,0,0,0,0,0,0,0,0,0,0,0,0,0
2016,11,94,9403,PAPUA,JAYAPURA,5039,5039,4717,322,0,17,7,150,127,145,155,116,91,392,321,0,0,301,300,207,713,0,0,1025,353,34,102,0,820,701,1521,1514
2016,11,94,9471,PAPUA,KOTA JAYAPURA,6520,6520,6009,511,0,9,11,114,83,153,133,108,76,531,407,0,0,217,286,184,938,0,9,867,540,7,211,0,915,710,1625,1625
2016,11,94,9420,PAPUA,KEEROM,1992,1992,1194,798,0,17,10,131,122,196,169,151,122,559,515,0,0,280,365,273,1074,0,0,1116,625,7,134,0,1054,938,1992,1882
2016,11,94,9419,PAPUA,SARMI,0,0,0,0,0,0,0,0,0,0,0,0,0,0,0,0,0,0,0,0,0,0,0,0,0,0,0,0,0,0,0,0
2016,11,94,9409,PAPUA,BIAK NUMFOR,1912,1892,1705,187,0,2,1,8,4,5,12,12,8,31,24,0,0,15,17,20,55,0,0,47,44,0,16,0,58,49,107,107
2016,11,94,9427,PAPUA,SUPIORI,287,204,204,0,0,0,1,7,2,3,2,5,1,16,15,0,0,10,5,6,31,0,0,18,35,0,4,0,31,21,52,57
2016,11,94,9401,PAPUA,MERAUKE,455,406,311,95,0,5,3,48,25,23,17,20,21,42,37,0,0,81,40,41,79,0,0,27,94,1,0,0,138,103,241,122
2016,11,94,9414,PAPUA,MAPPI,2296,2296,2009,287,0,14,6,88,77,72,55,27,24,117,77,0,0,185,127,51,194,0,0,423,94,0,40,0,318,239,557,557
2016,11,94,9413,PAPUA,BOVEN DIGOEL,610,610,279,331,0,8,8,44,68,29,30,19,24,50,46,0,0,128,59,43,96,0,0,160,106,0,61,0,150,176,326,327
2016,11,94,9404,PAPUA,NABIRE,4914,4914,3746,1168,0,18,9,40,44,36,29,24,13,146,144,0,0,111,65,37,290,0,0,244,220,0,9,0,264,239,503,473
2016,11,94,9408,PAPUA,KEPULAUAN YAPEN,0,0,0,0,0,0,0,0,0,0,0,0,0,0,0,0,0,0,0,0,0,0,0,0,0,0,0,0,0,0,0,0
2016,11,94,9412,PAPUA,MIMIKA,4120,4120,2958,1162,0,20,19,160,159,208,182,183,130,1247,761,0,0,358,390,313,2008,0,0,2112,1590,79,375,0,1818,1251,3069,4156
2016,11,94,9410,PAPUA,PANIAI,513,513,286,227,0,1,2,11,17,9,15,11,13,29,43,0,0,31,24,24,72,0,0,118,33,0,0,0,61,90,151,151
2016,11,94,9415,PAPUA,ASMAT,0,0,0,0,0,0,0,0,0,0,0,0,0,0,0,0,0,0,0,0,0,0,0,0,0,0,0,0,0,0,0,0
2016,11,94,9426,PAPUA,WAROPEN,0,0,0,0,0,0,0,0,0,0,0,0,0,0,0,0,0,0,0,0,0,0,0,0,0,0,0,0,0,0,0,0
2016,11,94,9402,PAPUA,JAYAWIJAYA,866,866,556,310,0,2,0,1,0,0,0,0,1,33,32,0,0,3,0,1,65,0,0,25,40,0,4,0,36,33,69,69
2016,11,94,9411,PAPUA,PUNCAK JAYA,0,0,0,0,0,0,0,0,0,0,0,0,0,0,0,0,0,0,0,0,0,0,0,0,0,0,0,0,0,0,0,0
2016,11,94,9418,PAPUA,TOLIKARA,0,0,0,0,0,0,0,0,0,0,0,0,0,0,0,0,0,0,0,0,0,0,0,0,0,0,0,0,0,0,0,0
2016,11,94,9416,PAPUA,YAHUKIMO,114,114,114,0,0,0,0,3,3,3,5,2,0,32,7,0,0,6,8,2,39,0,0,28,21,0,6,0,40,15,55,55
2016,11,94,9417,PAPUA,PEGUNUNGAN BINTANG,0,0,0,0,0,0,0,0,0,0,0,0,0,0,0,0,0,0,0,0,0,0,0,0,0,0,0,0,0,0,0,0
2016,11,94,9428,PAPUA,MAMBERAMO RAYA,0,0,0,0,0,0,0,0,0,0,0,0,0,0,0,0,0,0,0,0,0,0,0,0,0,0,0,0,0,0,0,0
2016,11,94,9429,PAPUA,NDUGA,0,0,0,0,0,0,0,0,0,0,0,0,0,0,0,0,0,0,0,0,0,0,0,0,0,0,0,0,0,0,0,0
2016,11,94,9430,PAPUA,LANNY JAYA,0,0,0,0,0,0,0,0,0,0,0,0,0,0,0,0,0,0,0,0,0,0,0,0,0,0,0,0,0,0,0,0
2016,11,94,9431,PAPUA,MAMBERAMO TENGAH,0,0,0,0,0,0,0,0,0,0,0,0,0,0,0,0,0,0,0,0,0,0,0,0,0,0,0,0,0,0,0,0
2016,11,94,9432,PAPUA,YALIMO,0,0,0,0,0,0,0,0,0,0,0,0,0,0,0,0,0,0,0,0,0,0,0,0,0,0,0,0,0,0,0,0
2016,11,94,9433,PAPUA,PUNCAK,0,0,0,0,0,0,0,0,0,0,0,0,0,0,0,0,0,0,0,0,0,0,0,0,0,0,0,0,0,0,0,0
2016,11,94,9434,PAPUA,DOGIYAI,0,0,0,0,0,0,0,0,0,0,0,0,0,0,0,0,0,0,0,0,0,0,0,0,0,0,0,0,0,0,0,0
2016,11,94,9435,PAPUA,INTAN JAYA,61,61,51,10,0,0,2,9,6,10,10,3,3,21,8,0,0,17,20,6,29,0,0,73,1,0,9,0,43,29,72,83
2016,11,94,9436,PAPUA,DEIYAI,0,0,0,0,0,0,0,0,0,0,0,0,0,0,0,0,0,0,0,0,0,0,0,0,0,0,0,0,0,0,0,0
2016,12,91,9171,PAPUA BARAT,KOTA SORONG,382,362,336,26,0,0,0,1,0,1,0,0,0,1,0,0,0,1,1,0,1,0,0,0,3,0,0,0,3,0,3,3
2016,12,91,9107,PAPUA BARAT,SORONG,0,0,0,0,0,0,0,0,0,0,0,0,0,0,0,0,0,0,0,0,0,0,0,0,0,0,0,0,0,0,0,0
2016,12,91,9106,PAPUA BARAT,SORONG SELATAN,0,0,0,0,0,0,0,0,0,0,0,0,0,0,0,0,0,0,0,0,0,0,0,0,0,0,0,0,0,0,0,0
2016,12,91,9108,PAPUA BARAT,RAJA AMPAT,0,0,0,0,0,0,0,0,0,0,0,0,0,0,0,0,0,0,0,0,0,0,0,0,0,0,0,0,0,0,0,0
2016,12,91,9105,PAPUA BARAT,MANOKWARI,0,0,0,0,0,0,0,0,0,0,0,0,0,0,0,0,0,0,0,0,0,0,0,0,0,0,0,0,0,0,0,0
2016,12,91,9104,PAPUA BARAT,TELUK BINTUNI,406,406,317,89,0,0,0,1,0,0,0,0,0,4,0,0,0,1,0,0,4,0,0,2,3,0,0,0,5,0,5,5
2016,12,91,9103,PAPUA BARAT,TELUK WONDAMA,0,0,0,0,0,0,0,0,0,0,0,0,0,0,0,0,0,0,0,0,0,0,0,0,0,0,0,0,0,0,0,0
2016,12,91,9101,PAPUA BARAT,FAKFAK,0,0,0,0,0,0,0,0,0,0,0,0,0,0,0,0,0,0,0,0,0,0,0,0,0,0,0,0,0,0,0,0
2016,12,91,9102,PAPUA BARAT,KAIMANA,0,0,0,0,0,0,0,0,0,0,0,0,0,0,0,0,0,0,0,0,0,0,0,0,0,0,0,0,0,0,0,0
2016,12,91,9109,PAPUA BARAT,TAMBRAUW,0,0,0,0,0,0,0,0,0,0,0,0,0,0,0,0,0,0,0,0,0,0,0,0,0,0,0,0,0,0,0,0
2016,12,91,9110,PAPUA BARAT,MAYBRAT,0,0,0,0,0,0,0,0,0,0,0,0,0,0,0,0,0,0,0,0,0,0,0,0,0,0,0,0,0,0,0,0
2016,12,91,9112,PAPUA BARAT,PEGUNUNGAN ARFAK,0,0,0,0,0,0,0,0,0,0,0,0,0,0,0,0,0,0,0,0,0,0,0,0,0,0,0,0,0,0,0,0
2016,12,91,9111,PAPUA BARAT,MANOKWARI SELATAN,0,0,0,0,0,0,0,0,0,0,0,0,0,0,0,0,0,0,0,0,0,0,0,0,0,0,0,0,0,0,0,0
2016,12,94,9403,PAPUA,JAYAPURA,2668,2668,2599,69,0,9,2,44,52,44,43,33,24,201,145,0,0,107,87,57,346,0,0,372,154,7,64,0,331,266,597,597
2016,12,94,9471,PAPUA,KOTA JAYAPURA,3715,3715,3276,439,0,2,7,75,59,76,60,63,48,352,225,0,0,143,136,111,577,0,13,582,312,7,66,0,568,399,967,967
2016,12,94,9420,PAPUA,KEEROM,1547,1547,1007,540,0,17,15,114,118,155,140,107,75,458,347,0,0,264,295,182,805,0,0,828,514,3,202,0,851,695,1546,1547
2016,12,94,9419,PAPUA,SARMI,0,0,0,0,0,0,0,0,0,0,0,0,0,0,0,0,0,0,0,0,0,0,0,0,0,0,0,0,0,0,0,0
2016,12,94,9409,PAPUA,BIAK NUMFOR,675,662,571,91,0,0,0,8,5,12,4,13,5,16,22,0,0,13,16,18,38,0,0,34,39,0,12,0,49,36,85,85
2016,12,94,9427,PAPUA,SUPIORI,289,193,193,0,0,2,1,8,2,2,6,1,3,16,16,0,0,13,8,4,32,0,2,26,37,0,2,0,29,28,57,65
2016,12,94,9401,PAPUA,MERAUKE,250,248,152,96,0,7,4,21,16,6,8,6,2,37,18,0,0,48,14,8,55,0,0,11,67,0,0,0,77,48,125,78
2016,12,94,9414,PAPUA,MAPPI,1315,1315,1175,140,0,10,6,52,33,37,30,28,28,67,61,0,0,101,67,56,128,0,0,276,47,0,17,0,194,158,352,340
2016,12,94,9413,PAPUA,BOVEN DIGOEL,355,355,47,308,0,6,8,52,37,25,23,9,16,38,26,0,0,103,48,25,64,0,0,98,63,0,81,0,130,110,240,242
2016,12,94,9404,PAPUA,NABIRE,2788,2788,2509,279,0,17,3,57,31,26,31,22,18,106,114,0,0,108,57,40,220,0,0,123,60,1,2,0,228,197,425,186
2016,12,94,9408,PAPUA,KEPULAUAN YAPEN,0,0,0,0,0,0,0,0,0,0,0,0,0,0,0,0,0,0,0,0,0,0,0,0,0,0,0,0,0,0,0,0
2016,12,94,9412,PAPUA,MIMIKA,5198,5198,4704,494,0,12,10,82,66,134,104,98,87,895,636,0,0,170,238,185,1531,0,0,992,1033,10,91,0,1221,903,2124,2126
2016,12,94,9410,PAPUA,PANIAI,65,65,0,65,0,0,0,0,0,0,1,0,2,3,10,0,0,0,1,2,13,0,0,16,0,0,0,0,3,13,16,16
2016,12,94,9415,PAPUA,ASMAT,0,0,0,0,0,0,0,0,0,0,0,0,0,0,0,0,0,0,0,0,0,0,0,0,0,0,0,0,0,0,0,0
2016,12,94,9426,PAPUA,WAROPEN,0,0,0,0,0,0,0,0,0,0,0,0,0,0,0,0,0,0,0,0,0,0,0,0,0,0,0,0,0,0,0,0
2016,12,94,9402,PAPUA,JAYAWIJAYA,211,211,150,61,0,0,2,2,1,2,0,0,0,8,9,0,0,5,2,0,17,0,0,11,11,0,2,0,12,12,24,24
2016,12,94,9411,PAPUA,PUNCAK JAYA,0,0,0,0,0,0,0,0,0,0,0,0,0,0,0,0,0,0,0,0,0,0,0,0,0,0,0,0,0,0,0,0
2016,12,94,9418,PAPUA,TOLIKARA,0,0,0,0,0,0,0,0,0,0,0,0,0,0,0,0,0,0,0,0,0,0,0,0,0,0,0,0,0,0,0,0
2016,12,94,9416,PAPUA,YAHUKIMO,228,228,223,5,0,0,0,4,5,0,0,1,0,18,6,0,0,9,0,1,24,0,0,14,17,0,2,0,23,11,34,33
2016,12,94,9417,PAPUA,PEGUNUNGAN BINTANG,0,0,0,0,0,0,0,0,0,0,0,0,0,0,0,0,0,0,0,0,0,0,0,0,0,0,0,0,0,0,0,0
2016,12,94,9428,PAPUA,MAMBERAMO RAYA,0,0,0,0,0,0,0,0,0,0,0,0,0,0,0,0,0,0,0,0,0,0,0,0,0,0,0,0,0,0,0,0
2016,12,94,9429,PAPUA,NDUGA,0,0,0,0,0,0,0,0,0,0,0,0,0,0,0,0,0,0,0,0,0,0,0,0,0,0,0,0,0,0,0,0
2016,12,94,9430,PAPUA,LANNY JAYA,0,0,0,0,0,0,0,0,0,0,0,0,0,0,0,0,0,0,0,0,0,0,0,0,0,0,0,0,0,0,0,0
2016,12,94,9431,PAPUA,MAMBERAMO TENGAH,0,0,0,0,0,0,0,0,0,0,0,0,0,0,0,0,0,0,0,0,0,0,0,0,0,0,0,0,0,0,0,0
2016,12,94,9432,PAPUA,YALIMO,0,0,0,0,0,0,0,0,0,0,0,0,0,0,0,0,0,0,0,0,0,0,0,0,0,0,0,0,0,0,0,0
2016,12,94,9433,PAPUA,PUNCAK,0,0,0,0,0,0,0,0,0,0,0,0,0,0,0,0,0,0,0,0,0,0,0,0,0,0,0,0,0,0,0,0
2016,12,94,9434,PAPUA,DOGIYAI,0,0,0,0,0,0,0,0,0,0,0,0,0,0,0,0,0,0,0,0,0,0,0,0,0,0,0,0,0,0,0,0
2016,12,94,9435,PAPUA,INTAN JAYA,0,0,0,0,0,0,0,0,0,0,0,0,0,0,0,0,0,0,0,0,0,0,0,0,0,0,0,0,0,0,0,0
2016,12,94,9436,PAPUA,DEIYAI,0,0,0,0,0,0,0,0,0,0,0,0,0,0,0,0,0,0,0,0,0,0,0,0,0,0,0,0,0,0,0,0
2017,1,91,9101,PAPUA BARAT,FAKFAK,3039,3039,2873,166,0,12,11,39,57,31,23,13,5,28,17,0,0,119,54,18,45,0,0,231,5,0,0,0,123,113,236,236
2017,1,91,9102,PAPUA BARAT,KAIMANA,129,129,91,38,0,1,0,1,2,4,4,3,2,14,6,0,0,4,8,5,20,0,0,19,10,0,8,0,23,14,37,37
2017,1,91,9103,PAPUA BARAT,TELUK WONDAMA,439,439,439,0,0,4,4,27,24,13,11,5,2,35,51,0,0,59,24,7,86,0,10,100,74,0,2,0,84,92,176,176
2017,1,91,9104,PAPUA BARAT,TELUK BINTUNI,557,557,557,0,0,0,1,1,1,2,5,0,0,6,3,0,0,3,7,0,9,0,0,9,10,0,0,0,9,10,19,19
2017,1,91,9105,PAPUA BARAT,MANOKWARI,749,749,749,0,0,35,23,104,101,45,54,33,41,159,170,0,0,263,99,74,329,0,4,204,545,0,16,0,376,389,765,765
2017,1,91,9106,PAPUA BARAT,SORONG SELATAN,479,479,314,165,0,0,3,0,4,5,1,0,2,7,8,0,0,7,6,2,15,0,0,9,21,0,0,0,12,18,30,30
2017,1,91,9107,PAPUA BARAT,SORONG,379,379,120,259,0,0,0,1,0,0,2,0,1,6,4,0,0,1,2,1,10,0,0,2,9,0,3,0,7,7,14,14
2017,1,91,9108,PAPUA BARAT,RAJA AMPAT,470,470,130,340,0,1,0,5,2,9,9,8,6,19,15,0,0,8,18,14,34,0,27,25,45,0,4,0,42,32,74,74
2017,1,91,9109,PAPUA BARAT,TAMBRAUW,179,179,52,127,0,0,0,3,1,0,3,3,1,5,7,0,0,4,3,4,12,0,0,14,0,0,9,0,11,12,23,23
2017,1,91,9110,PAPUA BARAT,MAYBRAT,0,0,0,0,0,0,0,1,0,0,0,0,0,0,0,0,0,1,0,0,0,0,0,0,1,0,0,0,1,0,1,1
2017,1,91,9111,PAPUA BARAT,MANOKWARI SELATAN,616,616,579,37,0,2,0,6,5,6,7,4,4,19,15,0,0,13,13,8,34,0,0,42,16,0,10,0,37,31,68,68
2017,1,91,9112,PAPUA BARAT,PEGUNUNGAN ARFAK,0,0,0,0,0,0,0,0,0,0,0,0,0,0,0,0,0,0,0,0,0,0,0,0,0,0,0,0,0,0,0,0
2017,1,91,9171,PAPUA BARAT,KOTA SORONG,672,672,481,191,0,1,0,2,4,7,4,5,2,6,16,0,0,7,11,7,22,0,0,18,20,0,9,0,21,26,47,47
2017,1,94,9471,PAPUA,KOTA JAYAPURA,4855,5101,4844,257,0,4,8,110,79,121,87,105,88,551,363,0,0,201,208,193,914,0,14,864,552,20,80,0,891,625,1516,1516
2017,1,94,9403,PAPUA,JAYAPURA,5728,5727,5036,691,0,18,18,204,186,190,189,178,144,408,472,5,4,426,379,322,880,9,1,1369,468,17,162,0,1003,1013,2016,2016
2017,1,94,9420,PAPUA,KEEROM,1865,2049,1373,676,0,16,15,145,120,197,179,134,115,584,494,28,22,296,376,249,1078,50,21,1147,680,10,212,0,1104,945,2049,2049
2017,1,94,9419,PAPUA,SARMI,1375,1375,1192,183,0,6,6,131,101,141,130,81,70,444,265,0,0,244,271,151,709,0,12,776,534,0,65,0,803,572,1375,1375
2017,1,94,9409,PAPUA,BIAK NUMFOR,1778,1814,1442,372,0,0,0,7,7,9,10,10,6,24,20,0,0,14,19,16,44,0,1,46,25,0,22,0,50,43,93,93
2017,1,94,9427,PAPUA,SUPIORI,603,36,36,0,0,0,1,5,4,3,3,3,1,11,5,0,0,10,6,4,16,0,0,17,17,0,2,0,22,14,36,36
2017,1,94,9401,PAPUA,MERAUKE,770,587,341,246,0,14,9,60,37,39,41,36,42,166,142,1,0,120,80,78,308,1,0,172,401,14,0,0,316,271,587,587
2017,1,94,9414,PAPUA,MAPPI,1587,1587,975,612,0,4,2,41,45,33,35,15,12,43,43,0,0,92,68,27,86,0,16,211,34,0,28,0,136,137,273,273
2017,1,94,9413,PAPUA,BOVEN DIGOEL,1719,758,587,171,0,17,19,99,109,78,64,37,59,136,149,6,2,244,142,96,285,8,0,450,235,1,89,0,373,402,775,775
2017,1,94,9404,PAPUA,NABIRE,6856,6856,6201,655,0,21,18,49,84,31,26,36,23,216,110,0,0,172,57,59,326,0,2,365,234,2,13,0,353,261,614,614
2017,1,94,9408,PAPUA,KEPULAUAN YAPEN,2321,2117,1865,252,0,42,43,121,108,78,69,31,40,142,337,0,0,314,147,71,479,0,20,845,151,0,15,0,414,597,1011,1011
2017,1,94,9412,PAPUA,MIMIKA,8575,7934,7192,742,0,65,69,459,409,461,446,387,323,3079,2236,0,0,1002,907,710,5315,0,88,4172,3127,195,440,0,4451,3483,7934,7934
2017,1,94,9410,PAPUA,PANIAI,471,57,0,57,0,0,0,1,2,1,2,2,6,7,22,14,0,3,3,8,29,14,0,36,21,0,0,0,25,32,57,57
2017,1,94,9415,PAPUA,ASMAT,1908,1394,1228,166,0,25,23,184,141,122,100,73,63,458,205,0,0,373,222,136,663,0,3,973,260,0,161,0,862,532,1394,1394
2017,1,94,9426,PAPUA,WAROPEN,297,233,233,0,0,3,7,27,20,18,25,9,17,36,70,1,0,57,43,26,106,1,16,201,27,1,4,0,94,139,233,233
2017,1,94,9402,PAPUA,JAYAWIJAYA,106,106,88,18,0,1,0,3,2,4,2,6,0,50,37,0,1,6,6,6,87,1,16,46,56,1,3,0,64,42,106,106
2017,1,94,9411,PAPUA,PUNCAK JAYA,113,113,113,0,0,0,0,7,5,4,8,4,5,29,51,0,0,12,12,9,80,0,0,70,43,0,0,0,44,69,113,113
2017,1,94,9418,PAPUA,TOLIKARA,77,77,16,61,0,0,1,1,0,1,0,0,1,3,0,0,0,2,1,1,3,0,0,1,2,0,4,0,5,2,7,7
2017,1,94,9416,PAPUA,YAHUKIMO,1471,1471,1471,0,0,60,47,162,156,95,68,74,56,410,333,8,2,425,163,130,743,10,0,955,490,0,26,0,809,662,1471,1471
2017,1,94,9417,PAPUA,PEGUNUNGAN BINTANG,282,282,282,0,0,11,12,40,33,7,11,5,6,101,56,0,0,96,18,11,157,0,0,189,93,0,0,0,164,118,282,282
2017,1,94,9428,PAPUA,MAMBERAMO RAYA,813,813,599,214,0,6,14,77,62,65,61,70,52,134,84,12,4,159,126,122,218,16,11,299,332,0,10,0,364,277,641,641
2017,1,94,9429,PAPUA,NDUGA,50,36,28,8,0,0,0,0,0,0,0,2,2,6,5,2,2,0,0,4,11,4,0,9,8,0,2,0,10,9,19,19
2017,1,94,9430,PAPUA,LANNY JAYA,28,28,28,0,0,0,0,0,0,0,0,1,0,2,3,0,0,0,0,1,5,0,0,2,4,0,0,0,3,3,6,6
2017,1,94,9431,PAPUA,MAMBERAMO TENGAH,1,1,0,1,0,0,0,0,0,0,0,0,0,0,1,0,0,0,0,0,1,0,0,1,0,0,0,0,0,1,1,1
2017,1,94,9432,PAPUA,YALIMO,214,46,39,7,0,1,1,5,7,5,3,2,1,13,8,0,0,14,8,3,21,0,0,30,14,0,2,0,26,20,46,46
2017,1,94,9433,PAPUA,PUNCAK,14,14,12,2,0,0,0,0,0,1,0,2,1,7,3,0,0,0,1,3,10,0,0,5,6,0,3,0,10,4,14,14
2017,1,94,9434,PAPUA,DOGIYAI,41,41,0,41,0,1,0,6,5,0,3,1,2,11,11,1,0,12,3,3,22,1,0,6,33,0,2,0,20,21,41,41
2017,1,94,9435,PAPUA,INTAN JAYA,46,46,0,46,0,0,0,0,0,0,0,13,7,18,13,0,0,0,0,20,31,0,5,10,41,0,0,0,31,20,51,51
2017,1,94,9436,PAPUA,DEIYAI,0,0,0,0,0,0,0,0,0,0,0,0,0,0,0,0,0,0,0,0,0,0,0,0,0,0,0,0,0,0,0,0
2017,2,91,9101,PAPUA BARAT,FAKFAK,3972,3972,3791,181,0,26,15,101,82,64,52,16,12,39,48,0,0,224,116,28,87,0,0,433,14,0,8,0,246,209,455,455
2017,2,91,9102,PAPUA BARAT,KAIMANA,95,95,55,40,0,0,0,1,3,2,3,0,0,7,1,0,0,4,5,0,8,0,0,7,2,0,8,0,10,7,17,17
2017,2,91,9103,PAPUA BARAT,TELUK WONDAMA,271,271,271,0,0,0,3,21,23,17,6,8,4,18,18,0,0,47,23,12,36,0,7,66,47,0,5,0,64,54,118,118
2017,2,91,9104,PAPUA BARAT,TELUK BINTUNI,847,847,847,0,0,2,0,10,9,5,8,1,0,10,13,0,0,21,13,1,23,0,6,31,27,0,0,0,28,30,58,58
2017,2,91,9105,PAPUA BARAT,MANOKWARI,634,634,634,0,0,25,16,92,76,63,55,37,30,138,120,0,0,209,118,67,258,0,12,104,537,0,11,0,355,297,652,652
2017,2,91,9106,PAPUA BARAT,SORONG SELATAN,1056,1056,1056,0,0,2,0,4,2,4,3,2,1,9,11,0,0,8,7,3,20,0,0,9,29,0,0,0,21,17,38,38
2017,2,91,9107,PAPUA BARAT,SORONG,434,434,118,316,0,0,1,1,0,0,0,0,0,6,2,0,0,2,0,0,8,0,0,7,3,0,0,0,7,3,10,10
2017,2,91,9108,PAPUA BARAT,RAJA AMPAT,143,143,135,8,0,0,0,6,1,11,0,7,5,9,5,0,0,7,11,12,14,0,6,24,20,0,0,0,33,11,44,44
2017,2,91,9109,PAPUA BARAT,TAMBRAUW,98,98,52,46,0,1,0,10,2,1,9,2,0,5,5,0,0,13,10,2,10,0,0,28,6,0,1,0,19,16,35,35
2017,2,91,9110,PAPUA BARAT,MAYBRAT,0,0,0,0,0,0,0,0,0,0,0,0,0,0,0,0,0,0,0,0,0,0,0,0,0,0,0,0,0,0,0,0
2017,2,91,9111,PAPUA BARAT,MANOKWARI SELATAN,978,978,845,133,0,1,1,8,8,11,8,13,8,49,23,0,0,18,19,21,72,0,0,67,25,0,38,0,82,48,130,130
2017,2,91,9112,PAPUA BARAT,PEGUNUNGAN ARFAK,0,0,0,0,0,0,0,0,0,0,0,0,0,0,0,0,0,0,0,0,0,0,0,0,0,0,0,0,0,0,0,0
2017,2,91,9171,PAPUA BARAT,KOTA SORONG,655,655,496,159,0,0,1,5,2,6,5,5,3,24,16,0,0,8,11,8,40,0,0,47,18,0,2,0,40,27,67,67
2017,2,94,9471,PAPUA,KOTA JAYAPURA,7223,7223,6643,580,0,11,7,137,92,128,144,116,150,845,549,0,0,247,272,266,1394,0,16,1264,737,22,156,0,1237,942,2179,2179
2017,2,94,9403,PAPUA,JAYAPURA,5626,5626,5082,544,0,17,12,155,145,197,175,165,138,404,477,0,6,329,372,303,881,6,0,1291,439,32,129,0,938,953,1891,1891
2017,2,94,9420,PAPUA,KEEROM,2003,2106,1630,476,0,3,15,165,121,219,175,160,132,574,492,31,19,304,394,292,1066,50,17,1230,686,5,185,0,1152,954,2106,2106
2017,2,94,9419,PAPUA,SARMI,1624,1397,1207,190,0,14,5,128,115,136,110,77,60,482,270,0,0,262,246,137,752,0,8,803,530,3,61,0,837,560,1397,1397
2017,2,94,9409,PAPUA,BIAK NUMFOR,1630,1624,1448,176,0,3,0,5,3,9,4,5,5,29,26,0,0,11,13,10,55,0,0,49,35,0,5,0,51,38,89,89
2017,2,94,9427,PAPUA,SUPIORI,494,32,32,0,0,0,2,2,1,3,3,2,3,4,12,0,0,5,6,5,16,0,1,8,23,0,1,0,11,21,32,32
2017,2,94,9401,PAPUA,MERAUKE,1147,661,534,127,0,21,18,83,62,66,54,27,32,168,126,3,1,184,120,59,294,4,0,223,434,2,2,0,368,293,661,661
2017,2,94,9414,PAPUA,MAPPI,1910,1910,1549,361,0,5,3,58,42,42,38,11,11,66,47,0,0,108,80,22,113,0,3,252,38,0,33,0,182,141,323,323
2017,2,94,9413,PAPUA,BOVEN DIGOEL,1537,861,577,284,0,24,16,115,113,89,82,32,48,146,154,6,5,268,171,80,300,11,9,461,268,0,101,0,412,418,830,830
2017,2,94,9404,PAPUA,NABIRE,7167,7167,6613,554,0,13,7,43,32,30,26,23,15,183,120,0,0,95,56,38,303,0,0,277,198,1,16,0,292,200,492,492
2017,2,94,9408,PAPUA,KEPULAUAN YAPEN,2422,2213,1999,214,0,15,14,146,106,109,83,68,43,191,370,0,0,281,192,111,561,0,57,896,228,0,21,0,529,616,1145,1145
2017,2,94,9412,PAPUA,MIMIKA,6551,6551,6327,224,0,76,53,429,390,478,361,363,279,2240,1882,0,0,948,839,642,4122,0,80,3452,2575,184,340,0,3586,2965,6551,6551
2017,2,94,9410,PAPUA,PANIAI,407,72,0,72,0,0,0,3,2,0,0,6,10,18,33,0,0,5,0,16,51,0,0,45,27,0,174,0,27,45,72,246
2017,2,94,9415,PAPUA,ASMAT,1628,1212,973,239,0,15,27,132,100,141,81,68,90,347,251,0,0,274,222,158,598,0,5,814,222,0,176,0,703,549,1252,1212
2017,2,94,9426,PAPUA,WAROPEN,87,87,79,8,0,1,2,2,2,2,0,1,3,31,43,0,0,7,2,4,74,0,0,45,37,1,4,0,37,50,87,87
2017,2,94,9402,PAPUA,JAYAWIJAYA,56,56,43,13,0,2,1,1,2,2,0,0,3,23,22,0,0,6,2,3,45,0,0,23,29,0,4,0,28,28,56,56
2017,2,94,9411,PAPUA,PUNCAK JAYA,98,98,96,2,0,2,1,8,5,4,3,9,6,32,28,0,0,16,7,15,60,0,2,63,35,0,0,0,55,43,98,98
2017,2,94,9418,PAPUA,TOLIKARA,119,119,100,19,0,1,0,1,3,1,0,0,0,4,2,0,0,5,1,0,6,0,0,4,6,0,2,0,7,5,12,12
2017,2,94,9416,PAPUA,YAHUKIMO,1913,1913,1913,0,0,48,57,164,138,125,89,88,63,695,446,0,0,407,214,151,1141,0,1,1219,673,0,21,0,1120,793,1913,1913
2017,2,94,9417,PAPUA,PEGUNUNGAN BINTANG,231,231,231,0,0,8,6,29,23,14,12,11,11,72,45,0,0,66,26,22,117,0,0,143,81,0,7,0,134,97,231,231
2017,2,94,9428,PAPUA,MAMBERAMO RAYA,734,734,628,106,0,6,8,25,33,36,31,52,36,165,138,6,4,72,67,88,303,10,9,385,145,0,10,0,290,250,540,540
2017,2,94,9429,PAPUA,NDUGA,50,42,32,10,0,0,0,0,0,0,0,1,2,5,4,5,4,0,0,3,9,9,0,11,7,0,3,0,11,10,21,21
2017,2,94,9430,PAPUA,LANNY JAYA,19,19,19,0,0,0,0,0,0,0,0,0,1,2,6,0,0,0,0,1,8,0,0,4,4,0,1,0,2,7,9,9
2017,2,94,9431,PAPUA,MAMBERAMO TENGAH,27,27,27,0,0,0,2,3,3,3,0,1,2,6,7,0,0,8,3,3,13,0,0,14,6,0,7,0,13,14,27,27
2017,2,94,9432,PAPUA,YALIMO,285,56,47,9,0,1,0,7,5,0,0,3,2,27,11,0,0,13,0,5,38,0,0,38,16,0,2,0,38,18,56,56
2017,2,94,9433,PAPUA,PUNCAK,17,17,14,3,0,0,0,0,0,0,0,2,0,13,2,0,0,0,0,2,15,0,0,14,2,0,1,0,15,2,17,17
2017,2,94,9434,PAPUA,DOGIYAI,112,62,62,0,0,0,2,9,9,1,1,0,2,17,27,1,1,20,2,2,44,2,0,6,54,0,2,0,28,42,70,62
2017,2,94,9435,PAPUA,INTAN JAYA,42,42,0,42,0,0,0,0,0,0,0,5,2,16,23,0,0,0,0,7,39,0,4,8,38,0,0,0,21,25,46,46
2017,2,94,9436,PAPUA,DEIYAI,1089,1089,1089,0,0,51,44,115,123,73,56,48,44,276,249,8,2,333,129,92,525,10,0,757,323,9,0,0,571,518,1089,1089
2017,3,91,9101,PAPUA BARAT,FAKFAK,3661,3661,3661,0,0,10,11,51,38,41,27,8,9,29,38,0,0,110,68,17,67,0,0,238,24,0,0,0,139,123,262,262
2017,3,91,9102,PAPUA BARAT,KAIMANA,269,262,192,70,0,0,1,5,0,1,1,0,0,6,5,0,0,6,2,0,11,0,0,11,5,0,3,0,12,7,19,19
2017,3,91,9103,PAPUA BARAT,TELUK WONDAMA,261,261,187,74,0,6,5,23,25,22,12,7,8,53,40,0,0,59,34,15,93,0,1,157,37,0,7,0,111,90,201,201
2017,3,91,9104,PAPUA BARAT,TELUK BINTUNI,521,521,521,0,0,0,0,2,0,2,3,1,0,5,1,0,0,2,5,1,6,0,0,6,8,0,0,0,10,4,14,14
2017,3,91,9105,PAPUA BARAT,MANOKWARI,578,578,476,102,0,39,24,93,81,42,47,39,16,187,128,0,0,237,89,55,315,0,5,130,553,0,13,0,400,296,696,696
2017,3,91,9106,PAPUA BARAT,SORONG SELATAN,706,706,638,68,0,2,1,2,0,1,0,0,0,7,2,0,0,5,1,0,9,0,0,5,10,0,0,0,12,3,15,15
2017,3,91,9107,PAPUA BARAT,SORONG,411,309,136,173,0,0,0,1,0,2,0,2,0,8,4,0,0,1,2,2,12,0,0,5,10,0,2,0,13,4,17,17
2017,3,91,9108,PAPUA BARAT,RAJA AMPAT,163,163,149,14,0,0,0,4,7,2,6,1,11,9,2,0,0,11,8,12,11,0,0,25,17,0,0,0,16,26,42,42
2017,3,91,9109,PAPUA BARAT,TAMBRAUW,165,165,117,48,0,0,0,12,4,10,13,4,2,13,10,0,0,16,23,6,23,0,0,53,4,0,11,0,39,29,68,68
2017,3,91,9110,PAPUA BARAT,MAYBRAT,1,1,0,1,0,0,0,0,0,0,0,0,0,0,1,0,0,0,0,0,1,0,0,0,1,0,0,0,0,1,1,1
2017,3,91,9111,PAPUA BARAT,MANOKWARI SELATAN,1116,1116,963,153,0,1,5,21,11,14,10,4,9,35,23,0,0,38,24,13,58,0,0,66,34,0,33,0,75,58,133,133
2017,3,91,9112,PAPUA BARAT,PEGUNUNGAN ARFAK,0,0,0,0,0,0,0,0,0,0,0,0,0,0,0,0,0,0,0,0,0,0,0,0,0,0,0,0,0,0,0,0
2017,3,91,9171,PAPUA BARAT,KOTA SORONG,725,698,530,168,0,0,0,2,0,10,5,3,2,22,11,0,0,2,15,5,33,0,0,36,14,0,5,0,37,18,55,55
2017,3,94,9471,PAPUA,KOTA JAYAPURA,5306,5306,4785,521,0,6,6,84,108,137,98,109,81,823,423,0,0,204,235,190,1246,0,15,989,765,16,105,0,1159,716,1875,1875
2017,3,94,9403,PAPUA,JAYAPURA,4858,4858,4399,459,0,31,17,215,170,237,198,157,157,597,551,6,7,433,435,314,1148,13,0,1572,642,30,99,0,1243,1100,2343,2343
2017,3,94,9420,PAPUA,KEEROM,1870,1870,1365,505,0,18,9,139,112,191,154,143,97,529,448,18,12,278,345,240,977,30,16,1088,564,11,207,0,1038,832,1870,1870
2017,3,94,9419,PAPUA,SARMI,1988,1801,1660,141,0,15,15,178,150,171,135,110,73,594,360,0,0,358,306,183,954,0,8,862,805,4,130,0,1068,733,1801,1801
2017,3,94,9409,PAPUA,BIAK NUMFOR,1298,1269,1221,48,0,0,0,5,1,0,4,2,1,12,10,0,0,6,4,3,22,0,0,18,14,0,3,0,19,16,35,35
2017,3,94,9427,PAPUA,SUPIORI,508,26,26,0,0,0,1,2,3,2,2,0,1,6,9,0,0,6,4,1,15,0,0,5,21,0,0,0,10,16,26,26
2017,3,94,9401,PAPUA,MERAUKE,1252,836,756,80,0,14,11,81,66,77,54,41,34,245,213,0,0,172,131,75,458,0,0,102,730,0,4,0,458,378,836,836
2017,3,94,9414,PAPUA,MAPPI,2033,2033,1565,468,0,1,45,47,50,41,19,14,47,54,26,0,0,143,60,61,80,0,13,256,63,0,25,0,157,187,344,344
2017,3,94,9413,PAPUA,BOVEN DIGOEL,1579,1147,881,266,0,18,22,147,139,112,107,78,85,195,184,6,3,326,219,163,379,9,6,537,375,0,184,0,556,540,1096,1096
2017,3,94,9404,PAPUA,NABIRE,4912,4912,4274,638,0,3,4,29,26,23,16,21,14,116,72,0,0,62,39,35,188,0,0,144,166,0,14,0,192,132,324,324
2017,3,94,9408,PAPUA,KEPULAUAN YAPEN,2805,2345,2031,314,0,53,41,101,123,74,79,50,53,235,420,0,0,318,153,103,655,0,27,975,202,0,52,0,513,716,1229,1229
2017,3,94,9412,PAPUA,MIMIKA,7596,7596,5381,2215,0,55,49,496,412,510,413,348,261,2825,2227,0,0,1012,923,609,5052,0,88,3721,3223,190,462,0,4234,3362,7596,7596
2017,3,94,9410,PAPUA,PANIAI,762,189,176,13,0,5,0,19,26,11,16,10,6,45,50,0,1,50,27,16,95,1,0,134,55,0,0,0,90,99,189,189
2017,3,94,9415,PAPUA,ASMAT,1191,1161,764,397,0,21,26,142,133,99,117,67,36,333,217,0,0,322,216,103,550,0,21,891,270,0,275,0,662,529,1191,1436
2017,3,94,9426,PAPUA,WAROPEN,274,83,75,8,0,1,2,0,2,2,2,6,1,44,23,0,0,5,4,7,67,0,0,45,38,0,0,0,53,30,83,83
2017,3,94,9402,PAPUA,JAYAWIJAYA,38,38,34,4,0,0,1,0,2,1,2,2,0,22,8,0,0,3,3,2,30,0,0,7,31,0,0,0,25,13,38,38
2017,3,94,9411,PAPUA,PUNCAK JAYA,67,67,67,0,0,4,2,0,5,5,5,5,1,20,19,0,1,11,10,6,39,1,0,35,32,0,0,0,34,33,67,67
2017,3,94,9418,PAPUA,TOLIKARA,178,178,139,39,0,0,1,2,3,1,3,1,0,9,6,0,0,6,4,1,15,0,0,17,9,0,0,0,13,13,26,26
2017,3,94,9416,PAPUA,YAHUKIMO,2542,2542,2542,0,0,79,81,225,182,121,108,116,91,881,657,1,0,567,229,207,1538,1,0,1614,924,0,4,0,1423,1119,2542,2542
2017,3,94,9417,PAPUA,PEGUNUNGAN BINTANG,319,260,260,0,0,12,9,29,34,16,10,5,3,82,60,0,0,84,26,8,142,0,0,197,57,0,6,0,144,116,260,260
2017,3,94,9428,PAPUA,MAMBERAMO RAYA,653,653,555,98,0,1,8,37,26,42,38,44,39,200,119,4,4,72,80,83,319,8,9,352,210,0,0,0,328,234,562,562
2017,3,94,9429,PAPUA,NDUGA,34,50,40,10,0,0,0,0,0,0,0,4,3,8,5,3,3,0,0,7,13,6,0,10,15,0,1,0,15,11,26,26
2017,3,94,9430,PAPUA,LANNY JAYA,8,8,8,0,0,0,0,0,0,0,0,0,0,0,1,0,0,0,0,0,1,0,0,0,1,0,0,0,0,1,1,1
2017,3,94,9431,PAPUA,MAMBERAMO TENGAH,21,21,14,7,0,0,0,2,2,1,0,0,0,14,2,0,0,4,1,0,16,0,0,12,3,0,6,0,17,4,21,21
2017,3,94,9432,PAPUA,YALIMO,222,59,37,22,0,0,1,3,2,2,4,1,4,33,9,0,0,6,6,5,42,0,0,40,14,0,5,0,39,20,59,59
2017,3,94,9433,PAPUA,PUNCAK,25,25,18,7,0,0,0,0,0,3,0,2,0,12,8,0,0,0,3,2,20,0,0,13,12,0,0,0,17,8,25,25
2017,3,94,9434,PAPUA,DOGIYAI,112,20,20,0,0,2,1,4,1,3,1,0,0,25,25,0,0,8,4,0,50,0,0,23,33,0,6,0,34,28,62,62
2017,3,94,9435,PAPUA,INTAN JAYA,37,37,0,37,0,0,0,0,0,0,0,5,0,19,17,0,0,0,0,5,36,0,3,1,40,0,0,0,24,17,41,41
2017,3,94,9436,PAPUA,DEIYAI,1097,1097,1097,0,0,42,48,107,94,74,40,40,34,342,276,0,0,291,114,74,618,0,0,751,327,0,19,0,605,492,1097,1097
2017,4,91,9101,PAPUA BARAT,FAKFAK,2800,2800,2655,145,0,0,4,27,23,9,10,1,4,25,17,0,0,54,19,5,42,0,0,103,10,0,7,0,62,58,120,120
2017,4,91,9102,PAPUA BARAT,KAIMANA,155,155,98,57,0,0,0,4,1,1,1,0,0,1,1,0,0,5,2,0,2,0,0,3,1,0,5,0,6,3,9,9
2017,4,91,9103,PAPUA BARAT,TELUK WONDAMA,1481,1481,1306,175,0,5,5,17,14,12,19,8,6,24,31,0,0,41,31,14,55,0,3,95,35,0,11,0,66,75,141,141
2017,4,91,9104,PAPUA BARAT,TELUK BINTUNI,493,493,493,0,0,0,2,3,3,1,0,2,1,4,1,0,0,8,1,3,5,0,0,3,13,0,1,0,10,7,17,17
2017,4,91,9105,PAPUA BARAT,MANOKWARI,507,507,433,74,0,15,17,75,54,36,23,26,12,183,77,0,0,161,59,38,260,0,5,131,353,0,34,0,335,183,518,518
2017,4,91,9106,PAPUA BARAT,SORONG SELATAN,598,593,504,89,0,1,1,4,1,3,4,1,4,9,17,0,0,7,7,5,26,0,3,7,33,0,5,0,18,27,45,45
2017,4,91,9107,PAPUA BARAT,SORONG,356,309,137,172,0,0,0,0,1,1,0,0,0,3,5,0,0,1,1,0,8,0,2,3,3,0,4,0,4,6,10,10
2017,4,91,9108,PAPUA BARAT,RAJA AMPAT,151,151,77,74,0,1,0,4,5,6,10,3,3,10,5,0,0,10,16,6,15,0,10,27,14,0,6,0,24,23,47,47
2017,4,91,9109,PAPUA BARAT,TAMBRAUW,203,203,135,68,0,1,1,12,4,6,8,2,3,18,12,0,0,18,14,5,30,0,0,52,9,0,6,0,39,28,67,67
2017,4,91,9110,PAPUA BARAT,MAYBRAT,0,0,0,0,0,0,0,0,0,0,0,0,0,0,0,0,0,0,0,0,0,0,0,0,0,0,0,0,0,0,0,0
2017,4,91,9111,PAPUA BARAT,MANOKWARI SELATAN,894,894,760,134,0,1,3,12,12,19,7,5,5,51,32,0,0,28,26,10,83,0,2,68,51,0,28,0,88,59,147,147
2017,4,91,9112,PAPUA BARAT,PEGUNUNGAN ARFAK,0,0,0,0,0,0,0,0,0,0,0,0,0,0,0,0,0,0,0,0,0,0,0,0,0,0,0,0,0,0,0,0
2017,4,91,9171,PAPUA BARAT,KOTA SORONG,562,509,365,144,0,0,0,1,1,4,4,4,1,10,7,0,0,2,8,5,17,0,0,15,12,0,5,0,19,13,32,32
2017,4,94,9471,PAPUA,KOTA JAYAPURA,5392,5392,4735,657,0,5,8,100,75,119,103,95,105,604,371,0,0,188,222,200,975,0,21,878,586,17,104,0,923,662,1585,1585
2017,4,94,9403,PAPUA,JAYAPURA,4970,4970,4147,823,0,25,20,213,192,225,260,172,164,571,520,5,5,450,485,336,1091,10,0,1728,498,32,114,0,1211,1161,2372,2372
2017,4,94,9420,PAPUA,KEEROM,1921,1988,1514,474,0,24,12,158,143,204,186,131,103,574,414,18,21,337,390,234,988,39,18,1104,650,9,225,0,1109,879,1988,1988
2017,4,94,9419,PAPUA,SARMI,117,1365,1268,97,0,7,9,132,120,145,113,83,48,456,252,0,0,268,258,131,708,0,14,713,544,1,107,0,823,542,1365,1365
2017,4,94,9409,PAPUA,BIAK NUMFOR,1040,1047,905,142,0,0,0,1,2,4,3,1,0,9,6,0,0,3,7,1,15,0,0,12,11,0,3,0,15,11,26,26
2017,4,94,9427,PAPUA,SUPIORI,430,39,39,0,0,1,0,7,5,3,2,4,3,7,7,0,0,13,5,7,14,0,0,12,27,0,0,0,22,17,39,39
2017,4,94,9401,PAPUA,MERAUKE,1194,595,486,109,0,13,8,81,51,55,45,23,19,167,133,0,0,153,100,42,300,0,0,240,352,3,0,0,339,256,595,595
2017,4,94,9414,PAPUA,MAPPI,2028,2028,1493,535,0,6,2,60,38,31,27,14,8,41,45,152,120,106,58,22,86,272,9,212,304,0,28,0,304,240,544,544
2017,4,94,9413,PAPUA,BOVEN DIGOEL,1690,1006,632,374,0,16,22,159,135,106,93,47,50,206,163,4,4,332,199,97,369,8,0,541,268,0,196,0,538,467,1005,1005
2017,4,94,9404,PAPUA,NABIRE,6747,6747,4775,1972,0,4,5,22,28,24,18,18,32,129,84,0,0,59,42,50,213,0,0,234,113,2,15,0,197,167,364,364
2017,4,94,9408,PAPUA,KEPULAUAN YAPEN,1978,919,763,156,0,32,17,106,94,66,70,37,33,125,339,0,0,249,136,70,464,0,32,743,155,0,21,0,366,553,919,919
2017,4,94,9412,PAPUA,MIMIKA,8816,4584,3328,1256,0,46,37,337,303,328,254,195,161,1672,1251,0,0,723,582,356,2923,0,28,2467,1757,73,287,0,2578,2006,4584,4584
2017,4,94,9410,PAPUA,PANIAI,204,124,103,21,0,4,0,17,19,6,2,1,1,34,39,1,0,40,8,2,73,1,0,102,22,0,0,0,63,61,124,124
2017,4,94,9415,PAPUA,ASMAT,1176,963,665,298,0,17,20,148,93,78,75,46,38,260,188,0,0,278,153,84,448,0,6,589,95,0,279,0,549,414,963,963
2017,4,94,9426,PAPUA,WAROPEN,0,129,120,9,0,0,0,2,3,2,5,0,6,40,70,1,0,5,7,6,110,1,16,71,53,1,4,0,45,84,129,129
2017,4,94,9402,PAPUA,JAYAWIJAYA,0,30,20,10,0,0,1,0,2,2,1,0,0,11,13,0,0,3,3,0,24,0,0,14,15,0,1,0,13,17,30,30
2017,4,94,9411,PAPUA,PUNCAK JAYA,0,121,121,0,0,5,7,3,10,7,3,16,4,39,27,0,0,25,10,20,66,0,3,73,48,0,0,0,70,51,121,121
2017,4,94,9418,PAPUA,TOLIKARA,0,0,0,0,0,0,0,0,0,0,0,0,0,0,0,0,0,0,0,0,0,0,0,0,0,0,0,0,0,0,0,0
2017,4,94,9416,PAPUA,YAHUKIMO,0,2050,2037,13,0,73,78,187,175,113,60,115,63,690,495,0,1,513,173,178,1185,1,0,1694,346,0,10,0,1178,872,2050,2050
2017,4,94,9417,PAPUA,PEGUNUNGAN BINTANG,278,244,244,0,0,14,7,29,33,12,7,5,1,89,46,1,0,83,19,6,135,1,0,184,55,0,5,0,150,94,244,244
2017,4,94,9428,PAPUA,MAMBERAMO RAYA,0,786,643,143,0,1,10,46,30,43,43,57,43,201,119,4,4,87,86,100,320,8,9,352,249,0,0,0,352,249,601,601
2017,4,94,9429,PAPUA,NDUGA,20,37,35,2,0,0,0,0,0,0,0,3,2,8,5,3,0,0,0,5,13,3,0,13,8,0,0,0,14,7,21,21
2017,4,94,9430,PAPUA,LANNY JAYA,0,8,4,4,0,0,0,0,0,0,0,0,0,0,0,0,0,0,0,0,0,0,0,0,0,0,0,0,0,0,0,0
2017,4,94,9431,PAPUA,MAMBERAMO TENGAH,0,16,16,0,0,0,0,2,0,0,2,0,0,0,10,2,0,2,2,0,10,2,1,13,3,0,0,0,4,12,16,16
2017,4,94,9432,PAPUA,YALIMO,251,43,31,12,0,1,0,4,3,0,2,7,0,17,9,0,0,8,2,7,26,0,0,21,22,0,0,0,29,14,43,43
2017,4,94,9433,PAPUA,PUNCAK,0,8,6,2,0,0,0,0,0,0,0,2,0,3,3,0,0,0,0,2,6,0,0,5,2,0,1,0,5,3,8,8
2017,4,94,9434,PAPUA,DOGIYAI,38,50,50,0,0,3,2,8,12,0,2,0,0,4,18,0,0,25,2,0,22,0,0,5,44,0,0,0,15,34,49,49
2017,4,94,9435,PAPUA,INTAN JAYA,0,53,0,53,0,0,0,0,0,0,0,4,3,23,27,0,0,0,0,7,50,0,4,5,52,0,0,0,27,30,57,57
2017,4,94,9436,PAPUA,DEIYAI,0,1452,1452,0,0,69,74,128,136,78,43,64,40,451,369,0,0,407,121,104,820,0,0,891,551,0,10,0,790,662,1452,1452
2017,5,91,9101,PAPUA BARAT,FAKFAK,2468,2468,2362,106,0,5,5,21,25,6,11,2,6,22,28,0,0,56,17,8,50,0,0,119,11,0,1,0,56,75,131,131
2017,5,91,9102,PAPUA BARAT,KAIMANA,113,100,60,40,0,0,1,6,4,3,1,0,0,4,1,0,0,11,4,0,5,0,0,7,7,0,6,0,13,7,20,20
2017,5,91,9103,PAPUA BARAT,TELUK WONDAMA,1180,1180,1013,167,0,2,0,30,16,12,14,2,3,32,16,0,0,48,26,5,48,0,10,55,46,0,26,0,78,49,127,127
2017,5,91,9104,PAPUA BARAT,TELUK BINTUNI,536,536,536,0,0,0,0,0,0,1,1,1,0,10,3,0,0,0,2,1,13,0,0,12,4,0,0,0,12,4,16,16
2017,5,91,9105,PAPUA BARAT,MANOKWARI,461,461,250,211,0,15,11,55,40,32,22,11,16,113,75,0,0,121,54,27,188,0,22,101,268,0,21,0,226,164,390,390
2017,5,91,9106,PAPUA BARAT,SORONG SELATAN,398,397,317,80,0,0,0,1,0,0,0,0,0,3,2,0,0,1,0,0,5,0,1,2,4,0,0,0,4,2,6,6
2017,5,91,9107,PAPUA BARAT,SORONG,449,312,118,194,0,1,0,1,0,0,0,1,0,4,0,0,0,2,0,1,4,0,0,1,6,0,0,0,7,0,7,7
2017,5,91,9108,PAPUA BARAT,RAJA AMPAT,183,183,0,183,0,1,1,6,1,6,2,4,2,6,8,0,0,9,8,6,14,0,0,5,19,0,13,0,23,14,37,37
2017,5,91,9109,PAPUA BARAT,TAMBRAUW,129,129,80,49,0,0,1,5,7,7,1,2,0,18,3,0,0,13,8,2,21,0,1,30,2,0,12,0,32,12,44,44
2017,5,91,9110,PAPUA BARAT,MAYBRAT,0,0,0,0,0,0,0,0,0,0,0,0,0,0,0,0,0,0,0,0,0,0,0,0,0,0,0,0,0,0,0,0
2017,5,91,9111,PAPUA BARAT,MANOKWARI SELATAN,990,990,874,116,0,2,1,20,12,11,9,5,3,46,28,0,0,35,20,8,74,0,3,79,32,0,26,0,84,53,137,137
2017,5,91,9112,PAPUA BARAT,PEGUNUNGAN ARFAK,0,0,0,0,0,0,0,0,0,0,0,0,0,0,0,0,0,0,0,0,0,0,0,0,0,0,0,0,0,0,0,0
2017,5,91,9171,PAPUA BARAT,KOTA SORONG,613,613,497,116,0,0,1,1,0,0,0,2,2,11,8,0,0,2,0,4,19,0,0,12,12,0,1,0,14,11,25,25
2017,5,94,9471,PAPUA,KOTA JAYAPURA,5452,5452,4915,537,0,10,6,94,78,101,90,75,70,542,346,0,0,188,191,145,888,0,11,760,504,11,137,0,822,590,1412,1412
2017,5,94,9403,PAPUA,JAYAPURA,5145,5184,4654,530,0,12,7,134,143,171,132,129,121,421,389,12,1,296,303,250,810,13,0,1126,427,22,97,0,879,793,1672,1672
2017,5,94,9420,PAPUA,KEEROM,2036,2103,1492,611,0,10,11,158,153,225,156,130,113,621,480,23,23,332,381,243,1101,46,20,1604,333,5,161,0,1167,936,2103,2103
2017,5,94,9419,PAPUA,SARMI,1578,1557,1484,73,0,5,15,148,131,170,155,74,80,503,276,0,0,299,325,154,779,0,9,823,616,6,112,0,900,657,1557,1557
2017,5,94,9409,PAPUA,BIAK NUMFOR,1193,1133,958,175,0,1,0,4,3,1,1,2,2,9,4,0,0,8,2,4,13,0,0,13,14,0,0,0,17,10,27,27
2017,5,94,9427,PAPUA,SUPIORI,654,32,32,0,0,0,2,5,8,3,2,1,2,6,3,0,0,15,5,3,9,0,0,15,17,0,0,0,15,17,32,32
2017,5,94,9401,PAPUA,MERAUKE,705,255,213,42,0,2,2,34,20,26,16,11,9,64,68,3,0,58,42,20,132,3,0,143,112,0,0,0,140,115,255,255
2017,5,94,9414,PAPUA,MAPPI,1959,1959,1475,484,0,5,2,37,21,23,21,7,10,26,30,0,0,65,44,17,56,0,0,126,31,1,24,0,98,84,182,182
2017,5,94,9413,PAPUA,BOVEN DIGOEL,2005,1166,728,438,0,22,22,149,135,131,118,52,66,185,218,4,3,328,249,118,403,7,0,539,336,0,230,0,543,562,1105,1105
2017,5,94,9404,PAPUA,NABIRE,9690,9611,5657,3954,0,10,7,35,44,39,33,26,19,192,139,0,0,96,72,45,331,0,1,365,160,0,19,0,302,242,544,544
2017,5,94,9408,PAPUA,KEPULAUAN YAPEN,2406,1992,1602,390,0,25,32,160,114,87,76,59,43,182,386,0,0,331,163,102,568,0,37,856,268,0,40,0,513,651,1164,1164
2017,5,94,9412,PAPUA,MIMIKA,3316,3304,2595,709,0,58,39,307,288,244,208,135,117,1018,890,0,0,692,452,252,1908,0,54,1822,1204,103,175,0,1762,1542,3304,3304
2017,5,94,9410,PAPUA,PANIAI,240,413,241,172,0,9,8,41,34,28,17,17,11,127,114,7,0,92,45,28,241,7,0,356,57,0,0,0,229,184,413,413
2017,5,94,9415,PAPUA,ASMAT,842,808,435,373,0,5,12,78,67,88,86,36,31,227,178,0,0,162,174,67,405,0,35,707,101,0,0,0,434,374,808,808
2017,5,94,9426,PAPUA,WAROPEN,0,0,0,0,0,0,0,0,0,0,0,0,0,0,0,0,0,0,0,0,0,0,0,0,0,0,0,0,0,0,0,0
2017,5,94,9402,PAPUA,JAYAWIJAYA,77,77,75,2,0,0,0,2,2,0,1,2,2,46,22,0,0,4,1,4,68,0,14,23,51,0,3,0,50,27,77,77
2017,5,94,9411,PAPUA,PUNCAK JAYA,96,96,96,0,0,4,1,3,6,4,4,5,4,33,32,0,0,14,8,9,65,0,1,52,44,0,0,0,49,47,96,96
2017,5,94,9418,PAPUA,TOLIKARA,0,0,0,0,0,0,0,0,0,0,0,0,0,0,0,0,0,0,0,0,0,0,0,0,0,0,0,0,0,0,0,0
2017,5,94,9416,PAPUA,YAHUKIMO,1955,1955,1928,27,0,77,73,226,178,117,79,96,47,636,425,1,0,554,196,143,1061,1,0,1092,822,0,41,0,1153,802,1955,1955
2017,5,94,9417,PAPUA,PEGUNUNGAN BINTANG,375,275,275,0,0,6,4,24,27,15,11,6,5,126,50,1,0,61,26,11,176,1,0,236,34,0,5,0,178,97,275,275
2017,5,94,9428,PAPUA,MAMBERAMO RAYA,840,840,742,98,0,1,8,37,26,42,38,44,39,200,119,4,4,72,80,83,319,8,9,352,210,0,0,0,328,234,562,562
2017,5,94,9429,PAPUA,NDUGA,41,28,21,7,0,0,0,0,0,0,0,2,2,7,3,1,4,0,0,4,10,5,0,9,9,0,1,0,10,9,19,19
2017,5,94,9430,PAPUA,LANNY JAYA,8,8,6,2,0,0,0,0,0,0,0,0,0,1,1,0,0,0,0,0,2,0,0,1,0,0,1,0,1,1,2,2
2017,5,94,9431,PAPUA,MAMBERAMO TENGAH,10,10,6,4,0,0,0,0,0,1,0,0,0,8,1,0,0,0,1,0,9,0,0,1,4,0,5,0,9,1,10,10
2017,5,94,9432,PAPUA,YALIMO,239,85,79,6,0,3,0,9,13,2,5,3,4,33,13,0,0,25,7,7,46,0,0,53,27,0,5,0,50,35,85,85
2017,5,94,9433,PAPUA,PUNCAK,0,0,0,0,0,0,0,0,0,0,0,0,0,0,0,0,0,0,0,0,0,0,0,0,0,0,0,0,0,0,0,0
2017,5,94,9434,PAPUA,DOGIYAI,116,50,50,0,0,3,2,8,12,0,2,0,0,4,18,1,0,25,2,0,22,1,0,10,36,0,4,0,16,34,50,50
2017,5,94,9435,PAPUA,INTAN JAYA,42,42,0,42,0,0,0,0,0,0,0,3,3,16,20,0,0,0,0,6,36,0,4,2,40,0,0,0,19,23,42,42
2017,5,94,9436,PAPUA,DEIYAI,1426,1426,1384,42,0,74,68,157,152,76,56,62,35,431,315,0,0,451,132,97,746,0,0,1217,192,0,17,0,800,626,1426,1426
2017,6,91,9101,PAPUA BARAT,FAKFAK,2377,2377,2290,87,0,0,0,3,3,4,1,0,0,6,6,0,0,6,5,0,12,0,1,17,3,0,3,0,13,10,23,23
2017,6,91,9102,PAPUA BARAT,KAIMANA,128,128,78,50,0,0,0,2,2,3,1,0,1,8,3,0,0,4,4,1,11,0,0,13,1,0,6,0,13,7,20,20
2017,6,91,9103,PAPUA BARAT,TELUK WONDAMA,1117,1117,1021,96,0,0,0,16,16,14,12,2,5,22,25,0,0,32,26,7,47,0,18,69,33,0,10,0,54,58,112,112
2017,6,91,9104,PAPUA BARAT,TELUK BINTUNI,492,492,492,0,0,0,1,3,2,1,0,1,0,17,2,0,0,6,1,1,19,0,0,11,14,2,0,0,22,5,27,27
2017,6,91,9105,PAPUA BARAT,MANOKWARI,500,500,481,19,0,4,2,23,24,18,18,8,6,78,66,0,0,53,36,14,144,0,32,69,153,0,25,0,131,116,247,247
2017,6,91,9106,PAPUA BARAT,SORONG SELATAN,343,343,296,47,0,0,0,0,0,0,0,0,0,0,0,0,0,0,0,0,0,0,0,0,0,0,0,0,0,0,0,0
2017,6,91,9107,PAPUA BARAT,SORONG,825,825,95,730,0,0,0,1,1,0,0,1,0,4,3,0,0,2,0,1,7,0,0,3,6,0,1,0,6,4,10,10
2017,6,91,9108,PAPUA BARAT,RAJA AMPAT,86,86,25,61,0,1,0,1,3,7,6,5,4,7,1,0,0,5,13,9,8,0,6,21,8,0,6,0,21,14,35,35
2017,6,91,9109,PAPUA BARAT,TAMBRAUW,126,126,97,29,0,0,0,9,10,12,5,2,6,21,26,0,0,19,17,8,47,0,0,58,17,0,16,0,44,47,91,91
2017,6,91,9110,PAPUA BARAT,MAYBRAT,0,0,0,0,0,0,0,0,0,0,0,0,0,0,0,0,0,0,0,0,0,0,0,0,0,0,0,0,0,0,0,0
2017,6,91,9111,PAPUA BARAT,MANOKWARI SELATAN,869,869,763,106,0,1,2,14,14,14,13,5,12,37,35,0,0,31,27,17,72,0,2,92,31,0,24,0,71,76,147,147
2017,6,91,9112,PAPUA BARAT,PEGUNUNGAN ARFAK,0,0,0,0,0,0,0,0,0,0,0,0,0,0,0,0,0,0,0,0,0,0,0,0,0,0,0,0,0,0,0,0
2017,6,91,9171,PAPUA BARAT,KOTA SORONG,658,658,319,339,0,0,0,0,0,1,0,1,1,7,5,0,0,0,1,2,12,0,0,10,5,0,0,0,9,6,15,15
2017,6,94,9471,PAPUA,KOTA JAYAPURA,4687,4687,4223,464,0,5,4,75,61,100,68,62,81,455,321,0,0,145,168,143,776,0,12,684,442,15,91,0,697,535,1232,1232
2017,6,94,9403,PAPUA,JAYAPURA,2519,2519,2087,432,0,9,13,114,99,131,119,92,88,227,256,1,5,235,250,180,483,6,1,786,279,21,68,0,574,580,1154,1154
2017,6,94,9420,PAPUA,KEEROM,1341,1541,1153,388,0,8,9,115,93,152,149,89,92,413,369,27,25,225,301,181,782,52,8,953,424,3,161,0,804,737,1541,1541
2017,6,94,9419,PAPUA,SARMI,548,548,527,21,0,6,7,62,53,65,51,27,22,158,97,0,0,128,116,49,255,0,0,264,245,0,39,0,318,230,548,548
2017,6,94,9409,PAPUA,BIAK NUMFOR,0,0,0,0,0,0,0,0,0,0,0,0,0,0,0,0,0,0,0,0,0,0,0,0,0,0,0,0,0,0,0,0
2017,6,94,9427,PAPUA,SUPIORI,496,11,10,1,0,0,0,1,1,1,0,1,0,5,2,0,0,2,1,1,7,0,0,0,9,1,1,0,8,3,11,11
2017,6,94,9401,PAPUA,MERAUKE,927,495,463,32,0,14,14,68,53,35,29,22,11,134,110,4,1,149,64,33,244,5,0,77,413,0,5,0,277,218,495,495
2017,6,94,9414,PAPUA,MAPPI,2032,2049,1558,491,0,14,7,56,46,33,23,14,15,43,36,0,0,123,56,29,79,0,1,170,62,0,55,0,160,127,287,287
2017,6,94,9413,PAPUA,BOVEN DIGOEL,2384,1170,688,482,0,27,18,170,125,127,117,51,56,247,212,4,5,340,244,107,459,9,6,654,282,1,222,0,626,533,1159,1159
2017,6,94,9404,PAPUA,NABIRE,8303,8303,6046,2257,0,8,4,52,35,30,29,24,20,210,111,0,0,99,59,44,321,0,0,316,173,0,34,0,324,199,523,523
2017,6,94,9408,PAPUA,KEPULAUAN YAPEN,2261,1859,1383,476,0,44,30,132,119,87,81,40,25,224,373,0,0,325,168,65,597,0,19,719,392,0,44,0,527,628,1155,1155
2017,6,94,9412,PAPUA,MIMIKA,7056,7056,6809,247,0,68,54,505,419,534,413,296,260,2535,1972,0,0,1046,947,556,4507,0,103,3971,2643,113,329,0,3938,3118,7056,7056
2017,6,94,9410,PAPUA,PANIAI,252,517,477,40,0,21,24,52,53,22,20,19,14,119,169,3,1,150,42,33,288,4,0,430,87,0,0,0,236,281,517,517
2017,6,94,9415,PAPUA,ASMAT,747,953,741,212,0,17,13,76,79,93,91,32,23,327,202,0,0,185,184,55,529,0,0,692,261,0,0,0,545,408,953,953
2017,6,94,9426,PAPUA,WAROPEN,0,0,0,0,0,0,0,0,0,0,0,0,0,0,0,0,0,0,0,0,0,0,0,0,0,0,0,0,0,0,0,0
2017,6,94,9402,PAPUA,JAYAWIJAYA,50,50,38,12,0,0,0,0,0,1,0,1,0,37,10,1,0,0,1,1,47,1,8,21,28,0,1,0,40,10,50,50
2017,6,94,9411,PAPUA,PUNCAK JAYA,66,66,66,0,0,2,0,2,5,5,3,4,3,14,27,1,0,9,8,7,41,1,1,47,19,0,0,0,28,38,66,66
2017,6,94,9418,PAPUA,TOLIKARA,0,0,0,0,0,0,0,0,0,0,0,0,0,0,0,0,0,0,0,0,0,0,0,0,0,0,0,0,0,0,0,0
2017,6,94,9416,PAPUA,YAHUKIMO,1690,1690,1645,45,0,70,53,170,134,117,54,102,61,566,361,1,1,427,171,163,927,2,6,957,686,0,47,0,1026,664,1690,1690
2017,6,94,9417,PAPUA,PEGUNUNGAN BINTANG,220,220,220,0,0,8,6,28,28,8,16,3,5,76,42,0,0,70,24,8,118,0,0,156,59,0,5,0,123,97,220,220
2017,6,94,9428,PAPUA,MAMBERAMO RAYA,0,751,653,98,0,1,10,41,27,42,40,47,46,200,119,4,4,79,82,93,319,8,9,392,189,0,0,0,335,246,581,581
2017,6,94,9429,PAPUA,NDUGA,15,30,23,7,0,0,0,0,0,0,0,1,2,2,5,2,3,0,0,3,7,5,0,6,9,0,0,0,5,10,15,15
2017,6,94,9430,PAPUA,LANNY JAYA,10,10,0,10,0,0,0,0,0,0,0,0,0,1,1,0,0,0,0,0,2,0,0,1,1,0,0,0,1,1,2,2
2017,6,94,9431,PAPUA,MAMBERAMO TENGAH,0,0,0,0,0,0,0,0,0,0,0,0,0,0,0,0,0,0,0,0,0,0,0,0,0,0,0,0,0,0,0,0
2017,6,94,9432,PAPUA,YALIMO,348,57,47,10,0,0,0,5,4,4,5,4,0,23,12,0,0,9,9,4,35,0,0,44,13,0,0,0,36,21,57,57
2017,6,94,9433,PAPUA,PUNCAK,0,0,0,0,0,0,0,0,0,0,0,0,0,0,0,0,0,0,0,0,0,0,0,0,0,0,0,0,0,0,0,0
2017,6,94,9434,PAPUA,DOGIYAI,33,18,18,0,0,0,1,4,2,0,3,2,0,2,4,0,0,7,3,2,6,0,0,11,6,0,1,0,8,10,18,18
2017,6,94,9435,PAPUA,INTAN JAYA,43,43,0,43,0,0,0,0,0,0,0,2,3,20,18,0,0,0,0,5,38,0,5,14,29,0,0,0,22,21,43,43
2017,6,94,9436,PAPUA,DEIYAI,1091,1091,956,135,0,61,47,114,97,67,45,60,32,327,241,0,0,319,112,92,568,0,0,789,267,0,35,0,629,462,1091,1091
2017,7,91,9101,PAPUA BARAT,FAKFAK,2377,2377,2290,87,0,13,4,34,37,18,11,2,9,27,16,0,0,88,29,11,43,0,0,149,19,0,3,0,94,77,171,171
2017,7,91,9102,PAPUA BARAT,KAIMANA,128,122,78,44,0,0,0,2,2,3,1,0,1,8,3,0,0,4,4,1,11,0,0,13,1,0,6,0,13,7,20,20
2017,7,91,9103,PAPUA BARAT,TELUK WONDAMA,1117,1117,1021,96,0,0,0,16,16,14,12,2,5,22,25,0,0,32,26,7,47,0,2,69,33,0,10,0,54,58,112,112
2017,7,91,9104,PAPUA BARAT,TELUK BINTUNI,492,492,492,0,0,1,2,3,3,1,0,1,0,16,2,0,0,9,1,1,18,0,1,10,17,0,0,2,22,7,29,29
2017,7,91,9105,PAPUA BARAT,MANOKWARI,500,500,481,19,0,4,2,23,24,18,18,8,6,78,66,0,0,53,36,14,144,0,20,69,153,0,25,0,131,116,247,247
2017,7,91,9106,PAPUA BARAT,SORONG SELATAN,343,90,44,46,0,0,0,0,0,0,0,0,0,0,0,0,0,0,0,0,0,0,1,0,0,0,0,0,0,0,0,0
2017,7,91,9107,PAPUA BARAT,SORONG,825,831,95,736,0,0,0,1,1,0,0,1,0,4,3,0,0,2,0,1,7,0,0,3,6,0,1,0,6,4,10,10
2017,7,91,9108,PAPUA BARAT,RAJA AMPAT,86,86,25,61,0,1,0,1,3,7,6,5,4,7,1,0,0,5,13,9,8,0,0,21,8,0,6,0,21,14,35,35
2017,7,91,9109,PAPUA BARAT,TAMBRAUW,126,126,97,29,0,0,0,9,10,12,5,2,6,21,26,0,0,19,17,8,47,0,1,58,17,0,16,0,44,47,91,91
2017,7,91,9110,PAPUA BARAT,MAYBRAT,0,0,0,0,0,0,0,0,0,0,0,0,0,0,0,0,0,0,0,0,0,0,0,0,0,0,0,0,0,0,0,0
2017,7,91,9111,PAPUA BARAT,MANOKWARI SELATAN,989,960,874,86,0,1,2,14,14,14,13,5,12,37,35,0,0,31,27,17,72,0,2,92,31,0,24,0,71,76,147,147
2017,7,91,9112,PAPUA BARAT,PEGUNUNGAN ARFAK,0,0,0,0,0,0,0,0,0,0,0,0,0,0,0,0,0,0,0,0,0,0,0,0,0,0,0,0,0,0,0,0
2017,7,91,9171,PAPUA BARAT,KOTA SORONG,658,534,319,215,0,0,0,0,0,1,0,1,1,7,5,0,0,0,1,2,12,0,13,10,5,0,0,0,9,6,15,15
2017,7,94,9471,PAPUA,KOTA JAYAPURA,5133,5133,4698,435,0,6,2,70,62,93,90,90,79,588,351,0,0,140,183,169,939,0,18,735,588,11,97,0,847,584,1431,1431
2017,7,94,9403,PAPUA,JAYAPURA,0,0,0,0,0,0,0,0,0,0,0,0,0,0,0,0,0,0,0,0,0,0,0,0,0,0,0,0,0,0,0,0
2017,7,94,9420,PAPUA,KEEROM,1694,1894,1367,527,0,13,9,120,114,136,130,121,109,634,462,22,24,256,266,230,1096,46,10,1167,547,10,170,0,1046,848,1894,1894
2017,7,94,9419,PAPUA,SARMI,382,1065,1065,0,0,11,6,84,97,94,106,54,46,258,200,0,0,198,200,100,458,0,8,546,323,0,87,0,501,455,956,956
2017,7,94,9409,PAPUA,BIAK NUMFOR,1229,1207,831,376,0,0,0,3,8,6,6,4,5,22,18,0,0,11,12,9,40,0,8,28,36,0,8,0,35,37,72,72
2017,7,94,9427,PAPUA,SUPIORI,584,10,7,3,0,0,0,2,0,2,1,1,1,3,0,0,0,2,3,2,3,0,0,5,2,0,3,0,8,2,10,10
2017,7,94,9401,PAPUA,MERAUKE,1433,611,537,74,0,17,10,61,59,43,49,18,27,153,139,20,15,147,92,45,292,35,0,182,422,0,7,0,312,299,611,611
2017,7,94,9414,PAPUA,MAPPI,2363,2363,1894,469,0,2,7,44,44,47,38,15,17,71,47,0,0,97,85,32,118,0,3,233,41,0,58,0,179,153,332,332
2017,7,94,9413,PAPUA,BOVEN DIGOEL,1107,865,474,391,0,15,13,132,112,90,85,31,26,189,132,9,2,272,175,57,321,11,1,441,260,0,135,0,466,370,836,836
2017,7,94,9404,PAPUA,NABIRE,8898,8898,6402,2496,0,4,7,34,26,27,27,17,17,230,131,0,0,71,54,34,361,0,1,315,167,1,37,0,312,208,520,520
2017,7,94,9408,PAPUA,KEPULAUAN YAPEN,234,151,29,122,0,0,4,15,12,9,5,5,5,21,24,0,0,31,14,10,45,0,0,85,13,0,2,0,50,50,100,100
2017,7,94,9412,PAPUA,MIMIKA,0,0,0,0,0,0,0,0,0,0,0,0,0,0,0,0,0,0,0,0,0,0,0,0,0,0,0,0,0,0,0,0
2017,7,94,9410,PAPUA,PANIAI,442,442,129,313,0,14,6,51,45,15,14,11,17,110,159,0,0,116,29,28,269,0,0,353,89,0,0,0,201,241,442,442
2017,7,94,9415,PAPUA,ASMAT,805,805,269,536,0,12,13,71,72,57,49,25,27,166,110,0,0,168,106,52,276,0,2,278,179,0,145,0,331,271,602,602
2017,7,94,9426,PAPUA,WAROPEN,0,0,0,0,0,0,0,0,0,0,0,0,0,0,0,0,0,0,0,0,0,0,0,0,0,0,0,0,0,0,0,0
2017,7,94,9402,PAPUA,JAYAWIJAYA,81,81,76,5,0,1,0,3,0,0,1,8,0,39,27,2,0,4,1,8,66,2,13,26,53,0,2,0,53,28,81,81
2017,7,94,9411,PAPUA,PUNCAK JAYA,75,75,75,0,0,2,2,11,11,2,5,2,2,18,20,0,0,26,7,4,38,0,0,46,29,0,0,0,35,40,75,75
2017,7,94,9418,PAPUA,TOLIKARA,0,0,0,0,0,0,0,0,0,0,0,0,0,0,0,0,0,0,0,0,0,0,0,0,0,0,0,0,0,0,0,0
2017,7,94,9416,PAPUA,YAHUKIMO,562,562,531,31,0,25,18,59,38,30,33,26,16,177,140,0,0,140,63,42,317,0,0,516,31,15,0,0,317,245,562,562
2017,7,94,9417,PAPUA,PEGUNUNGAN BINTANG,243,243,243,0,0,2,4,31,12,11,16,11,10,100,46,0,0,49,27,21,146,0,0,172,64,0,7,0,155,88,243,243
2017,7,94,9428,PAPUA,MAMBERAMO RAYA,1002,1002,858,144,0,2,15,48,30,58,44,58,69,228,134,6,4,95,102,127,362,10,9,352,344,0,0,0,400,296,696,696
2017,7,94,9429,PAPUA,NDUGA,55,37,25,12,0,0,0,0,0,0,0,3,3,6,4,2,2,0,0,6,10,4,0,9,11,0,0,0,11,9,20,20
2017,7,94,9430,PAPUA,LANNY JAYA,21,21,10,11,0,0,0,0,0,0,0,0,0,3,1,0,0,0,0,0,4,0,0,3,0,0,1,0,3,1,4,4
2017,7,94,9431,PAPUA,MAMBERAMO TENGAH,16,16,0,16,0,0,0,0,1,0,0,0,0,13,2,0,0,1,0,0,15,0,0,4,5,0,7,0,13,3,16,16
2017,7,94,9432,PAPUA,YALIMO,372,56,38,18,0,0,0,5,4,4,6,4,0,22,11,0,0,9,10,4,33,0,0,43,13,0,0,0,35,21,56,56
2017,7,94,9433,PAPUA,PUNCAK,0,0,0,0,0,0,0,0,0,0,0,0,0,0,0,0,0,0,0,0,0,0,0,0,0,0,0,0,0,0,0,0
2017,7,94,9434,PAPUA,DOGIYAI,28,17,17,0,0,0,0,3,1,1,0,1,0,7,4,0,0,4,1,1,11,0,2,4,12,0,1,0,12,5,17,17
2017,7,94,9435,PAPUA,INTAN JAYA,39,39,0,39,0,0,0,0,0,0,0,3,1,16,19,0,0,0,0,4,35,0,2,2,37,0,0,0,19,20,39,39
2017,7,94,9436,PAPUA,DEIYAI,562,562,521,41,0,25,18,59,38,30,33,26,16,177,140,0,0,140,63,42,317,0,0,494,51,0,17,0,317,245,562,562
2017,8,91,9101,PAPUA BARAT,FAKFAK,2166,2166,1989,177,0,4,6,34,30,12,19,6,3,30,19,0,0,74,31,9,49,0,0,148,11,0,4,0,86,77,163,163
2017,8,91,9102,PAPUA BARAT,KAIMANA,35,35,0,35,0,0,0,0,1,0,0,1,0,2,0,0,0,1,0,1,2,0,0,2,1,0,1,0,3,1,4,4
2017,8,91,9103,PAPUA BARAT,TELUK WONDAMA,1929,1929,1455,474,0,4,1,17,17,17,20,2,10,37,29,0,0,39,37,12,66,0,3,108,40,0,6,0,77,77,154,154
2017,8,91,9104,PAPUA BARAT,TELUK BINTUNI,499,499,499,0,0,1,0,1,2,1,1,0,0,7,4,0,0,4,2,0,11,0,0,11,6,0,0,0,10,7,17,17
2017,8,91,9105,PAPUA BARAT,MANOKWARI,1107,1107,1107,0,0,40,57,107,115,75,67,41,29,203,228,0,0,319,142,70,431,0,54,293,601,0,68,0,466,496,962,962
2017,8,91,9106,PAPUA BARAT,SORONG SELATAN,509,509,346,163,0,0,1,0,2,0,0,1,1,3,6,0,0,3,0,2,9,0,0,1,11,0,2,0,4,10,14,14
2017,8,91,9107,PAPUA BARAT,SORONG,682,682,94,588,0,0,0,0,2,4,2,1,0,5,0,0,0,2,6,1,5,0,0,2,2,0,10,0,10,4,14,14
2017,8,91,9108,PAPUA BARAT,RAJA AMPAT,180,180,162,18,0,1,1,6,8,14,8,4,7,17,18,0,0,16,22,11,35,0,0,33,27,0,24,0,42,42,84,84
2017,8,91,9109,PAPUA BARAT,TAMBRAUW,138,138,70,68,0,0,0,2,0,2,1,0,0,11,4,0,0,2,3,0,15,0,0,13,0,0,7,0,15,5,20,20
2017,8,91,9110,PAPUA BARAT,MAYBRAT,1,1,0,1,0,0,0,0,0,0,0,0,0,1,0,0,0,0,0,0,1,0,0,0,1,0,0,0,1,0,1,1
2017,8,91,9111,PAPUA BARAT,MANOKWARI SELATAN,676,674,560,114,0,1,1,13,6,7,1,7,5,38,19,0,0,21,8,12,57,0,0,50,30,0,20,0,66,32,98,100
2017,8,91,9112,PAPUA BARAT,PEGUNUNGAN ARFAK,0,0,0,0,0,0,0,0,0,0,0,0,0,0,0,0,0,0,0,0,0,0,0,0,0,0,0,0,0,0,0,0
2017,8,91,9171,PAPUA BARAT,KOTA SORONG,735,735,322,413,0,0,0,0,0,2,0,2,2,8,2,0,0,0,2,4,10,0,0,4,9,0,3,0,12,4,16,16
2017,8,94,9471,PAPUA,KOTA JAYAPURA,5281,5281,4837,444,0,6,3,64,84,89,89,81,64,548,329,0,0,157,178,145,877,0,5,685,560,22,90,0,788,569,1357,1357
2017,8,94,9403,PAPUA,JAYAPURA,133,133,27,106,0,1,1,6,2,8,5,3,5,10,4,0,0,10,13,8,14,0,0,16,14,0,15,0,28,17,45,45
2017,8,94,9420,PAPUA,KEEROM,1562,1678,1200,478,0,4,9,82,93,137,131,130,107,484,457,22,22,188,268,237,941,44,60,1089,490,8,91,0,859,819,1678,1678
2017,8,94,9419,PAPUA,SARMI,1479,1461,1415,46,0,8,14,148,143,141,146,111,70,733,520,0,0,313,287,181,1253,0,17,1406,548,0,80,0,1141,893,2034,2034
2017,8,94,9409,PAPUA,BIAK NUMFOR,1040,946,301,645,0,0,2,7,8,4,5,7,2,7,13,0,0,17,9,9,20,0,1,19,31,0,5,0,25,30,55,55
2017,8,94,9427,PAPUA,SUPIORI,605,9,7,2,0,0,0,0,2,2,1,0,0,3,1,0,0,2,3,0,4,0,0,4,5,0,0,0,5,4,9,9
2017,8,94,9401,PAPUA,MERAUKE,0,0,0,0,0,0,0,0,0,0,0,0,0,3,0,0,0,0,0,0,3,0,0,0,0,0,0,0,3,0,3,0
2017,8,94,9414,PAPUA,MAPPI,2333,2335,1905,430,0,7,6,52,63,58,51,11,18,86,59,0,0,128,109,29,145,0,4,267,77,0,67,0,214,197,411,411
2017,8,94,9413,PAPUA,BOVEN DIGOEL,2017,925,591,334,0,26,20,134,121,116,78,47,44,190,157,3,1,301,194,91,347,4,7,451,340,0,146,0,516,421,937,937
2017,8,94,9404,PAPUA,NABIRE,6651,6751,5959,792,0,8,4,44,23,39,25,16,27,151,116,0,0,79,64,43,267,0,0,268,157,0,28,0,258,195,453,453
2017,8,94,9408,PAPUA,KEPULAUAN YAPEN,2726,2726,2431,295,0,43,30,154,178,133,104,80,73,306,524,15,14,405,237,153,830,29,36,1243,345,0,76,0,731,923,1654,1664
2017,8,94,9412,PAPUA,MIMIKA,0,0,0,0,0,0,0,0,0,0,0,0,0,0,0,0,0,0,0,0,0,0,0,0,0,0,0,0,0,0,0,0
2017,8,94,9410,PAPUA,PANIAI,239,559,474,85,0,14,15,84,42,32,30,17,10,147,168,0,0,155,62,27,315,0,0,499,60,0,0,0,294,265,559,559
2017,8,94,9415,PAPUA,ASMAT,649,502,240,262,0,15,21,73,65,64,50,16,33,115,86,0,0,174,114,49,201,0,23,300,150,0,88,0,283,255,538,538
2017,8,94,9426,PAPUA,WAROPEN,0,0,0,0,0,0,0,0,0,0,0,0,0,0,0,0,0,0,0,0,0,0,0,0,0,0,0,0,0,0,0,0
2017,8,94,9402,PAPUA,JAYAWIJAYA,82,82,79,3,0,0,0,3,3,4,3,7,5,35,22,0,0,6,7,12,57,0,24,18,60,0,4,0,49,33,82,82
2017,8,94,9411,PAPUA,PUNCAK JAYA,75,75,75,0,0,10,4,7,11,6,4,1,2,12,18,0,0,32,10,3,30,0,0,42,33,0,0,0,36,39,75,75
2017,8,94,9418,PAPUA,TOLIKARA,0,0,0,0,0,0,0,0,0,0,0,0,0,0,0,0,0,0,0,0,0,0,0,0,0,0,0,0,0,0,0,0
2017,8,94,9416,PAPUA,YAHUKIMO,0,0,0,0,0,0,0,0,0,0,0,0,0,0,0,0,0,0,0,0,0,0,0,0,0,0,0,0,0,0,0,0
2017,8,94,9417,PAPUA,PEGUNUNGAN BINTANG,141,141,141,0,0,1,2,19,10,11,5,4,2,68,19,0,0,32,16,6,87,0,0,97,40,0,4,0,103,38,141,141
2017,8,94,9428,PAPUA,MAMBERAMO RAYA,871,871,779,92,0,1,8,42,25,33,40,31,44,188,134,6,4,76,73,75,322,10,9,352,204,0,0,0,301,255,556,556
2017,8,94,9429,PAPUA,NDUGA,44,31,23,8,0,0,0,0,0,0,0,2,3,4,4,3,2,0,0,5,8,5,0,7,11,0,0,0,9,9,18,18
2017,8,94,9430,PAPUA,LANNY JAYA,3,3,2,1,0,0,0,0,0,0,0,0,0,2,1,0,0,0,0,0,3,0,0,0,1,0,2,0,2,1,3,3
2017,8,94,9431,PAPUA,MAMBERAMO TENGAH,0,3,0,3,0,0,0,0,0,0,0,0,0,2,1,0,0,0,0,0,3,0,0,0,3,0,0,0,2,1,3,3
2017,8,94,9432,PAPUA,YALIMO,454,141,126,15,0,1,1,6,12,7,7,8,6,66,27,0,0,20,14,14,93,0,0,73,56,0,12,0,88,53,141,141
2017,8,94,9433,PAPUA,PUNCAK,0,0,0,0,0,0,0,0,0,0,0,0,0,0,0,0,0,0,0,0,0,0,0,0,0,0,0,0,0,0,0,0
2017,8,94,9434,PAPUA,DOGIYAI,43,14,14,0,0,0,0,2,1,1,1,0,0,5,4,0,0,3,2,0,9,0,0,7,7,0,0,0,8,6,14,14
2017,8,94,9435,PAPUA,INTAN JAYA,43,43,0,43,0,0,0,0,0,0,0,1,0,8,25,0,9,0,0,1,33,9,3,11,32,0,0,0,9,34,43,43
2017,8,94,9436,PAPUA,DEIYAI,0,0,0,0,0,0,0,0,0,0,0,0,0,0,0,0,0,0,0,0,0,0,0,0,0,0,0,0,0,0,0,0
2017,9,91,9101,PAPUA BARAT,FAKFAK,1932,1929,1810,119,0,1,5,8,4,7,8,3,1,16,18,0,0,18,15,4,34,0,0,56,15,0,0,0,35,36,71,71
2017,9,91,9102,PAPUA BARAT,KAIMANA,25,25,0,25,0,0,0,1,2,0,0,0,0,1,0,0,0,3,0,0,1,0,0,0,0,0,4,0,2,2,4,4
2017,9,91,9103,PAPUA BARAT,TELUK WONDAMA,428,428,326,102,0,0,0,4,5,3,2,5,1,18,7,0,0,9,5,6,25,0,1,7,30,0,8,0,30,15,45,45
2017,9,91,9104,PAPUA BARAT,TELUK BINTUNI,458,458,458,0,0,0,0,1,0,0,1,1,1,10,5,0,0,1,1,2,15,0,0,9,10,0,0,0,12,7,19,19
2017,9,91,9105,PAPUA BARAT,MANOKWARI,330,275,269,6,0,16,20,32,33,18,10,9,10,59,55,0,0,101,28,19,114,0,0,110,141,0,11,0,134,128,262,262
2017,9,91,9106,PAPUA BARAT,SORONG SELATAN,348,348,252,96,0,0,0,0,0,0,0,0,0,0,0,0,0,0,0,0,0,0,0,0,0,0,0,0,0,0,0,0
2017,9,91,9107,PAPUA BARAT,SORONG,557,557,355,202,0,0,0,0,0,0,1,0,0,4,2,0,0,0,1,0,6,0,0,0,7,0,0,0,4,3,7,7
2017,9,91,9108,PAPUA BARAT,RAJA AMPAT,9,9,0,9,0,0,0,1,1,2,3,1,2,7,5,0,0,2,5,3,12,0,0,15,2,0,5,0,11,11,22,22
2017,9,91,9109,PAPUA BARAT,TAMBRAUW,107,107,107,0,0,0,0,3,1,0,3,3,1,5,7,0,0,4,3,4,12,0,0,14,0,0,9,0,11,12,23,23
2017,9,91,9110,PAPUA BARAT,MAYBRAT,3,3,0,3,0,0,0,0,0,0,0,0,0,0,1,0,0,0,0,0,1,0,0,0,1,0,0,0,0,1,1,1
2017,9,91,9111,PAPUA BARAT,MANOKWARI SELATAN,684,684,536,148,0,1,0,9,8,8,6,1,4,45,21,0,0,18,14,5,66,0,1,40,33,0,30,0,64,39,103,103
2017,9,91,9112,PAPUA BARAT,PEGUNUNGAN ARFAK,0,0,0,0,0,0,0,0,0,0,0,0,0,0,0,0,0,0,0,0,0,0,0,0,0,0,0,0,0,0,0,0
2017,9,91,9171,PAPUA BARAT,KOTA SORONG,426,426,258,168,0,0,0,0,0,1,2,3,0,10,1,0,0,0,3,3,11,0,0,11,5,0,1,0,14,3,17,17
2017,9,94,9471,PAPUA,KOTA JAYAPURA,5650,5650,5042,608,0,3,13,60,70,90,91,63,63,519,310,0,0,146,181,126,829,0,11,724,468,22,68,0,735,547,1282,1282
2017,9,94,9403,PAPUA,JAYAPURA,2094,2094,1146,948,0,10,5,67,52,70,74,35,39,142,112,0,0,134,144,74,254,0,0,345,164,8,89,0,324,282,606,606
2017,9,94,9420,PAPUA,KEEROM,1140,1244,932,312,0,3,4,69,55,109,94,90,84,378,316,26,16,131,203,174,694,42,8,799,379,6,60,0,675,569,1244,1244
2017,9,94,9419,PAPUA,SARMI,1889,1554,1479,75,0,10,10,173,156,175,140,90,92,414,357,0,0,349,315,182,771,0,9,981,521,5,110,0,862,755,1617,1617
2017,9,94,9409,PAPUA,BIAK NUMFOR,1230,1227,758,469,0,2,0,6,6,10,8,5,5,19,23,0,0,14,18,10,42,0,2,45,34,1,4,0,42,42,84,84
2017,9,94,9427,PAPUA,SUPIORI,446,6,4,2,0,0,0,1,0,0,1,0,0,3,1,0,0,1,1,0,4,0,0,3,2,0,1,0,4,2,6,6
2017,9,94,9401,PAPUA,MERAUKE,1269,413,356,57,0,12,10,57,44,53,35,22,21,79,67,6,7,123,88,43,146,13,0,47,364,0,2,0,229,184,413,413
2017,9,94,9414,PAPUA,MAPPI,2359,2359,2059,300,0,23,5,61,28,28,26,13,17,84,51,0,0,117,54,30,135,0,16,222,66,0,48,0,209,127,336,336
2017,9,94,9413,PAPUA,BOVEN DIGOEL,628,626,218,408,0,11,16,80,86,62,88,38,41,90,76,1,0,193,150,79,166,1,7,233,147,4,205,0,282,307,589,589
2017,9,94,9404,PAPUA,NABIRE,6214,5986,5162,824,0,6,1,30,22,30,14,15,16,112,69,0,0,59,44,31,181,0,0,209,90,1,15,0,193,122,315,315
2017,9,94,9408,PAPUA,KEPULAUAN YAPEN,1884,1606,1393,213,0,19,22,101,112,106,84,56,35,55,53,110,180,254,190,91,108,290,1,733,158,0,42,0,447,486,933,933
2017,9,94,9412,PAPUA,MIMIKA,0,0,0,0,0,0,0,0,0,0,0,0,0,0,0,0,0,0,0,0,0,0,0,0,0,0,0,0,0,0,0,0
2017,9,94,9410,PAPUA,PANIAI,202,99,99,0,0,1,0,11,5,1,2,7,4,27,39,2,0,17,3,11,66,2,0,58,41,0,0,0,49,50,99,99
2017,9,94,9415,PAPUA,ASMAT,1464,680,250,430,0,6,9,86,69,55,46,35,22,168,106,350,252,170,101,57,274,602,1,335,750,0,119,0,700,504,1204,1204
2017,9,94,9426,PAPUA,WAROPEN,0,0,0,0,0,0,0,0,0,0,0,0,0,0,0,0,0,0,0,0,0,0,0,0,0,0,0,0,0,0,0,0
2017,9,94,9402,PAPUA,JAYAWIJAYA,62,62,59,3,0,1,2,1,1,0,3,5,0,38,11,0,0,5,3,5,49,0,8,14,45,0,3,0,45,17,62,62
2017,9,94,9411,PAPUA,PUNCAK JAYA,54,54,54,0,0,0,0,6,3,4,0,1,0,18,20,0,2,9,4,1,38,2,5,51,2,0,1,0,29,25,54,54
2017,9,94,9418,PAPUA,TOLIKARA,0,0,0,0,0,0,0,0,0,0,0,0,0,0,0,0,0,0,0,0,0,0,0,0,0,0,0,0,0,0,0,0
2017,9,94,9416,PAPUA,YAHUKIMO,0,0,0,0,0,0,0,0,0,0,0,0,0,0,0,0,0,0,0,0,0,0,0,0,0,0,0,0,0,0,0,0
2017,9,94,9417,PAPUA,PEGUNUNGAN BINTANG,123,123,123,0,0,2,1,9,11,1,3,1,2,64,28,1,0,23,4,3,92,1,0,85,34,0,4,0,78,45,123,123
2017,9,94,9428,PAPUA,MAMBERAMO RAYA,856,856,669,187,0,1,10,47,25,46,42,47,41,204,126,4,4,83,88,88,330,8,9,352,245,0,0,0,349,248,597,597
2017,9,94,9429,PAPUA,NDUGA,74,52,38,14,0,0,0,0,0,0,0,3,2,7,6,4,4,0,0,5,13,8,0,8,16,0,2,0,14,12,26,26
2017,9,94,9430,PAPUA,LANNY JAYA,0,8,8,0,0,0,0,0,0,1,0,0,0,4,3,0,0,0,1,0,7,0,0,1,2,0,5,0,5,3,8,8
2017,9,94,9431,PAPUA,MAMBERAMO TENGAH,0,0,0,0,0,0,0,0,0,0,0,0,0,0,0,0,0,0,0,0,0,0,0,0,0,0,0,0,0,0,0,0
2017,9,94,9432,PAPUA,YALIMO,358,83,78,5,0,0,1,6,7,3,3,3,2,44,14,0,0,14,6,5,58,0,0,46,31,0,6,0,56,27,83,83
2017,9,94,9433,PAPUA,PUNCAK,0,0,0,0,0,0,0,0,0,0,0,0,0,0,0,0,0,0,0,0,0,0,0,0,0,0,0,0,0,0,0,0
2017,9,94,9434,PAPUA,DOGIYAI,38,4,4,0,0,0,0,0,1,0,0,0,0,1,2,0,0,1,0,0,3,0,0,2,2,0,0,0,1,3,4,4
2017,9,94,9435,PAPUA,INTAN JAYA,41,41,0,41,0,0,0,0,2,3,1,8,8,10,9,0,0,2,4,16,19,0,3,7,34,0,0,0,21,20,41,41
2017,9,94,9436,PAPUA,DEIYAI,0,0,0,0,0,0,0,0,0,0,0,0,0,0,0,0,0,0,0,0,0,0,0,0,0,0,0,0,0,0,0,0
2017,10,91,9101,PAPUA BARAT,FAKFAK,1686,1678,835,843,0,1,2,6,2,8,3,3,1,16,10,0,0,11,11,4,26,0,0,37,11,1,3,0,34,18,52,52
2017,10,91,9102,PAPUA BARAT,KAIMANA,139,139,139,0,0,1,0,1,0,2,1,1,0,11,3,0,0,2,3,1,14,0,0,19,1,0,0,0,16,4,20,20
2017,10,91,9103,PAPUA BARAT,TELUK WONDAMA,1486,1486,1403,83,0,6,1,28,11,26,11,12,7,28,24,0,0,46,37,19,52,0,1,99,52,0,3,0,100,54,154,154
2017,10,91,9104,PAPUA BARAT,TELUK BINTUNI,488,488,488,0,0,0,0,2,1,2,4,2,0,7,0,0,0,3,6,2,7,0,0,11,7,0,0,0,13,5,18,18
2017,10,91,9105,PAPUA BARAT,MANOKWARI,1302,1302,1302,0,0,24,38,107,76,45,42,53,28,125,114,0,0,245,87,81,239,0,0,125,495,0,32,0,354,298,652,652
2017,10,91,9106,PAPUA BARAT,SORONG SELATAN,2151,2151,1892,259,0,1,1,0,0,1,1,0,0,10,0,0,0,2,2,0,10,0,1,5,6,0,3,0,12,2,14,14
2017,10,91,9107,PAPUA BARAT,SORONG,436,436,237,199,0,0,0,1,2,0,0,1,1,3,2,0,0,3,0,2,5,0,0,3,4,0,3,0,5,5,10,10
2017,10,91,9108,PAPUA BARAT,RAJA AMPAT,183,183,0,183,0,1,1,6,1,6,2,4,2,6,8,0,0,9,8,6,14,0,5,7,17,0,13,0,23,14,37,37
2017,10,91,9109,PAPUA BARAT,TAMBRAUW,219,219,56,163,0,0,0,2,1,2,2,1,3,11,6,0,0,3,4,4,17,0,1,14,0,0,14,0,16,12,28,28
2017,10,91,9110,PAPUA BARAT,MAYBRAT,58,58,0,58,0,0,0,0,0,0,0,0,0,0,0,0,0,0,0,0,0,0,0,0,0,0,0,0,0,0,0,0
2017,10,91,9111,PAPUA BARAT,MANOKWARI SELATAN,853,853,723,130,0,3,0,19,12,11,10,2,3,52,26,0,0,34,21,5,78,0,0,82,38,0,18,0,87,51,138,138
2017,10,91,9112,PAPUA BARAT,PEGUNUNGAN ARFAK,0,0,0,0,0,0,0,0,0,0,0,0,0,0,0,0,0,0,0,0,0,0,0,0,0,0,0,0,0,0,0,0
2017,10,91,9171,PAPUA BARAT,KOTA SORONG,135,135,135,0,0,0,0,0,0,0,0,0,0,0,0,0,0,0,0,0,0,0,0,0,0,0,0,0,0,0,0,0
2017,10,94,9471,PAPUA,KOTA JAYAPURA,5169,5169,4641,528,0,3,8,85,68,76,59,57,45,534,285,0,0,164,135,102,819,0,14,598,501,23,98,0,755,465,1220,1220
2017,10,94,9403,PAPUA,JAYAPURA,4172,4228,3572,656,0,15,20,114,92,120,82,95,64,227,226,0,1,241,202,159,453,1,0,611,291,19,135,0,571,485,1056,1056
2017,10,94,9420,PAPUA,KEEROM,1495,1685,1144,541,0,13,7,91,99,147,107,112,91,447,353,26,10,210,254,203,800,36,9,867,484,13,139,0,836,667,1503,1503
2017,10,94,9419,PAPUA,SARMI,1291,1285,1225,60,0,9,12,117,75,105,105,50,58,379,263,0,0,213,210,108,642,0,28,760,327,6,80,0,660,513,1173,1173
2017,10,94,9409,PAPUA,BIAK NUMFOR,740,741,494,247,0,1,1,0,5,3,3,5,4,9,9,0,0,7,6,9,18,0,0,18,18,0,4,0,18,22,40,40
2017,10,94,9427,PAPUA,SUPIORI,3,3,3,0,0,0,0,0,0,1,0,0,0,1,1,0,0,0,1,0,2,0,0,1,2,0,0,0,2,1,3,3
2017,10,94,9401,PAPUA,MERAUKE,734,659,601,58,0,2,4,20,18,15,13,12,8,96,98,0,1,44,28,20,194,1,0,7,135,0,0,0,145,142,287,142
2017,10,94,9414,PAPUA,MAPPI,2545,2545,2000,545,0,8,5,55,45,50,43,14,16,83,83,0,0,113,93,30,166,0,3,266,82,0,54,0,210,192,402,402
2017,10,94,9413,PAPUA,BOVEN DIGOEL,1342,874,517,357,0,26,13,116,104,101,89,35,61,144,147,6,7,259,190,96,291,13,0,366,298,2,183,0,428,421,849,849
2017,10,94,9404,PAPUA,NABIRE,6681,1277,1277,0,0,3,4,33,38,31,20,27,22,148,113,0,0,78,51,49,261,0,0,296,125,1,17,0,242,197,439,439
2017,10,94,9408,PAPUA,KEPULAUAN YAPEN,262,2275,2067,208,0,48,43,143,146,123,104,49,57,218,377,13,12,380,227,106,595,25,12,999,283,0,51,0,594,739,1333,1333
2017,10,94,9412,PAPUA,MIMIKA,0,0,0,0,0,0,0,0,0,0,0,0,0,0,0,0,0,0,0,0,0,0,0,0,0,0,0,0,0,0,0,0
2017,10,94,9410,PAPUA,PANIAI,60,0,0,0,0,1,1,15,3,7,5,12,10,46,66,8,5,20,12,22,112,13,0,97,82,0,0,0,89,90,179,179
2017,10,94,9415,PAPUA,ASMAT,1061,532,99,433,0,9,10,67,65,58,45,36,17,119,105,0,0,151,103,53,224,0,0,296,85,0,150,0,289,242,531,531
2017,10,94,9426,PAPUA,WAROPEN,15,436,436,0,0,10,10,39,50,31,33,23,19,87,92,19,23,109,64,42,179,42,6,427,9,0,0,0,209,227,436,436
2017,10,94,9402,PAPUA,JAYAWIJAYA,77,77,72,5,0,0,1,1,4,0,0,1,6,41,23,0,0,6,0,7,64,0,17,14,60,0,3,0,43,34,77,77
2017,10,94,9411,PAPUA,PUNCAK JAYA,31,31,31,0,0,0,0,6,2,3,0,0,0,12,7,0,1,8,3,0,19,1,0,31,0,0,0,0,21,10,31,31
2017,10,94,9418,PAPUA,TOLIKARA,0,0,0,0,0,0,0,0,0,0,0,0,0,0,0,0,0,0,0,0,0,0,0,0,0,0,0,0,0,0,0,0
2017,10,94,9416,PAPUA,YAHUKIMO,0,0,0,0,0,0,0,0,0,0,0,0,0,0,0,0,0,0,0,0,0,0,0,0,0,0,0,0,0,0,0,0
2017,10,94,9417,PAPUA,PEGUNUNGAN BINTANG,0,0,0,0,0,0,0,0,0,0,0,0,0,0,0,0,0,0,0,0,0,0,0,0,0,0,0,0,0,0,0,0
2017,10,94,9428,PAPUA,MAMBERAMO RAYA,0,757,644,113,0,1,10,35,26,44,40,50,53,210,136,3,1,72,84,103,346,4,9,352,257,0,0,0,343,266,609,609
2017,10,94,9429,PAPUA,NDUGA,18,45,28,17,0,0,0,0,0,0,0,2,3,6,6,2,2,0,0,5,12,4,0,7,13,0,1,0,10,11,21,21
2017,10,94,9430,PAPUA,LANNY JAYA,6,6,4,2,0,0,0,0,0,0,0,0,0,5,1,0,0,0,0,0,6,0,0,1,2,0,3,0,5,1,6,6
2017,10,94,9431,PAPUA,MAMBERAMO TENGAH,20,20,19,1,0,0,0,1,0,0,0,0,0,14,5,0,0,1,0,0,19,0,0,15,5,0,0,0,15,5,20,20
2017,10,94,9432,PAPUA,YALIMO,373,373,373,0,0,2,1,12,3,2,4,5,2,46,14,0,0,18,6,7,60,0,0,44,33,0,14,0,67,24,91,91
2017,10,94,9433,PAPUA,PUNCAK,0,0,0,0,0,0,0,0,0,0,0,0,0,0,0,0,0,0,0,0,0,0,0,0,0,0,0,0,0,0,0,0
2017,10,94,9434,PAPUA,DOGIYAI,0,0,0,0,0,0,0,0,0,0,0,0,0,0,0,0,0,0,0,0,0,0,0,0,0,0,0,0,0,0,0,0
2017,10,94,9435,PAPUA,INTAN JAYA,98,98,0,98,0,0,0,3,2,0,6,4,3,5,2,0,0,5,6,7,7,0,0,5,14,0,6,0,12,13,25,25
2017,10,94,9436,PAPUA,DEIYAI,0,0,0,0,0,0,0,0,0,0,0,0,0,0,0,0,0,0,0,0,0,0,0,0,0,0,0,0,0,0,0,0
2017,11,91,9101,PAPUA BARAT,FAKFAK,758,735,616,119,0,1,0,2,4,2,4,2,1,5,8,0,0,7,6,3,13,0,0,20,9,0,0,0,12,17,29,29
2017,11,91,9102,PAPUA BARAT,KAIMANA,165,165,165,0,0,0,1,2,0,0,4,1,0,5,3,0,0,3,4,1,8,0,0,16,0,0,0,0,8,8,16,16
2017,11,91,9103,PAPUA BARAT,TELUK WONDAMA,1264,1264,854,410,0,3,3,17,17,17,18,1,6,20,41,0,0,40,35,7,61,0,0,85,47,0,11,0,58,85,143,143
2017,11,91,9104,PAPUA BARAT,TELUK BINTUNI,224,224,224,0,0,0,0,2,1,0,0,1,1,2,0,0,0,3,0,2,2,0,0,1,3,2,1,0,5,2,7,7
2017,11,91,9105,PAPUA BARAT,MANOKWARI,2495,1746,1642,104,0,44,31,174,133,100,72,36,22,286,233,0,0,382,172,58,519,0,0,323,791,0,17,0,640,491,1131,1131
2017,11,91,9106,PAPUA BARAT,SORONG SELATAN,903,903,277,626,0,0,0,1,0,0,0,0,0,0,0,0,0,1,0,0,0,0,0,0,1,0,0,0,1,0,1,1
2017,11,91,9107,PAPUA BARAT,SORONG,544,460,67,393,0,0,0,2,0,0,0,4,0,0,0,0,0,2,0,4,0,0,0,0,4,0,2,0,6,0,6,6
2017,11,91,9108,PAPUA BARAT,RAJA AMPAT,255,255,0,255,0,1,1,4,1,2,1,5,2,2,3,0,0,7,3,7,5,0,0,6,5,2,9,0,14,8,22,22
2017,11,91,9109,PAPUA BARAT,TAMBRAUW,144,114,22,92,0,0,0,1,3,2,2,4,2,5,6,0,0,4,4,6,11,0,0,18,0,0,7,0,12,13,25,25
2017,11,91,9110,PAPUA BARAT,MAYBRAT,0,0,0,0,0,0,0,0,0,0,0,0,0,0,0,0,0,0,0,0,0,0,0,0,0,0,0,0,0,0,0,0
2017,11,91,9111,PAPUA BARAT,MANOKWARI SELATAN,628,628,592,36,0,2,0,14,6,9,2,2,2,15,19,0,0,22,11,4,34,0,0,53,13,0,5,0,42,29,71,71
2017,11,91,9112,PAPUA BARAT,PEGUNUNGAN ARFAK,0,0,0,0,0,0,0,0,0,0,0,0,0,0,0,0,0,0,0,0,0,0,0,0,0,0,0,0,0,0,0,0
2017,11,91,9171,PAPUA BARAT,KOTA SORONG,296,296,296,0,0,0,0,0,0,1,0,2,0,4,1,0,0,0,1,2,5,0,0,5,2,0,1,0,7,1,8,8
2017,11,94,9471,PAPUA,KOTA JAYAPURA,4847,4847,3971,876,0,2,7,82,96,73,88,62,47,495,327,0,0,187,161,109,822,0,6,654,491,5,129,0,714,565,1279,1279
2017,11,94,9403,PAPUA,JAYAPURA,5750,5750,3860,1890,0,7,7,98,87,104,101,85,64,342,249,1,0,199,205,149,591,1,0,679,298,15,153,0,637,508,1145,1145
2017,11,94,9420,PAPUA,KEEROM,1297,1313,1099,214,0,14,10,87,82,84,73,85,74,580,477,9,6,193,157,159,1057,15,18,809,532,180,60,0,859,722,1581,1581
2017,11,94,9419,PAPUA,SARMI,1969,1547,1523,24,0,8,11,113,112,110,69,77,73,469,300,0,0,244,179,150,769,0,9,873,371,10,88,0,777,565,1342,1342
2017,11,94,9409,PAPUA,BIAK NUMFOR,815,781,499,282,0,1,1,3,3,6,4,2,0,12,5,0,0,8,10,2,17,0,1,16,20,0,1,0,24,13,37,37
2017,11,94,9427,PAPUA,SUPIORI,384,2,1,1,0,0,0,0,1,0,0,0,0,1,0,0,0,1,0,0,1,0,0,1,1,0,0,0,1,1,2,2
2017,11,94,9401,PAPUA,MERAUKE,258,260,93,167,0,1,0,14,15,12,5,3,4,22,18,0,0,30,17,7,40,0,0,9,82,0,3,0,52,42,94,94
2017,11,94,9414,PAPUA,MAPPI,2447,2447,1873,574,0,10,12,94,63,57,45,23,21,63,56,247,197,179,102,44,119,444,10,304,491,0,93,0,494,394,888,888
2017,11,94,9413,PAPUA,BOVEN DIGOEL,2039,695,307,388,0,12,20,118,118,88,82,39,31,112,132,1,3,268,170,70,244,4,0,358,236,0,162,0,370,386,756,756
2017,11,94,9404,PAPUA,NABIRE,6985,6985,5781,1204,0,4,6,34,22,22,29,29,19,144,89,0,0,66,51,48,233,0,0,249,133,0,16,0,233,165,398,398
2017,11,94,9408,PAPUA,KEPULAUAN YAPEN,2781,2471,2210,261,0,54,57,197,167,120,143,86,83,340,398,32,22,475,263,169,738,54,15,409,1244,0,46,0,829,870,1699,1699
2017,11,94,9412,PAPUA,MIMIKA,0,0,0,0,0,0,0,0,0,0,0,0,0,0,0,0,0,0,0,0,0,0,0,0,0,0,0,0,0,0,0,0
2017,11,94,9410,PAPUA,PANIAI,164,0,0,0,0,0,0,4,11,3,4,9,14,30,43,0,0,15,7,23,73,0,0,50,61,7,0,0,46,72,118,118
2017,11,94,9415,PAPUA,ASMAT,1009,644,161,483,0,25,18,113,111,78,62,24,14,111,79,0,0,267,140,38,190,0,5,368,107,0,160,0,351,284,635,635
2017,11,94,9426,PAPUA,WAROPEN,547,547,547,0,0,9,11,55,44,66,47,16,43,91,139,19,7,119,113,59,230,26,0,543,4,0,0,0,256,291,547,547
2017,11,94,9402,PAPUA,JAYAWIJAYA,65,65,63,2,0,0,1,1,3,3,1,1,0,34,21,0,0,5,4,1,55,0,11,26,36,0,3,0,39,26,65,65
2017,11,94,9411,PAPUA,PUNCAK JAYA,228,228,16,212,0,0,0,2,3,0,1,0,0,7,3,0,0,5,1,0,10,0,0,13,3,0,0,0,9,7,16,16
2017,11,94,9418,PAPUA,TOLIKARA,0,0,0,0,0,0,0,0,0,0,0,0,0,0,0,0,0,0,0,0,0,0,0,0,0,0,0,0,0,0,0,0
2017,11,94,9416,PAPUA,YAHUKIMO,0,0,0,0,0,0,0,0,0,0,0,0,0,0,0,0,0,0,0,0,0,0,0,0,0,0,0,0,0,0,0,0
2017,11,94,9417,PAPUA,PEGUNUNGAN BINTANG,0,0,0,0,0,0,0,0,0,0,0,0,0,0,0,0,0,0,0,0,0,0,0,0,0,0,0,0,0,0,0,0
2017,11,94,9428,PAPUA,MAMBERAMO RAYA,856,856,669,187,0,1,10,25,46,42,47,41,204,126,4,4,349,82,89,245,130,353,9,352,547,0,0,0,239,660,899,899
2017,11,94,9429,PAPUA,NDUGA,35,25,17,8,0,0,0,0,0,0,0,2,1,3,3,1,2,0,0,3,6,3,0,4,8,0,0,0,6,6,12,12
2017,11,94,9430,PAPUA,LANNY JAYA,0,0,0,0,0,0,0,0,0,0,0,0,0,0,0,0,0,0,0,0,0,0,0,0,0,0,0,0,0,0,0,0
2017,11,94,9431,PAPUA,MAMBERAMO TENGAH,20,20,19,1,0,0,0,0,1,0,0,0,0,14,5,0,0,1,0,0,19,0,0,15,5,0,0,0,14,6,20,20
2017,11,94,9432,PAPUA,YALIMO,523,523,523,0,0,0,0,12,12,4,3,1,2,43,11,0,0,24,7,3,54,0,0,35,47,0,6,0,60,28,88,88
2017,11,94,9433,PAPUA,PUNCAK,0,0,0,0,0,0,0,0,0,0,0,0,0,0,0,0,0,0,0,0,0,0,0,0,0,0,0,0,0,0,0,0
2017,11,94,9434,PAPUA,DOGIYAI,0,0,0,0,0,0,0,0,0,0,0,0,0,0,0,0,0,0,0,0,0,0,0,0,0,0,0,0,0,0,0,0
2017,11,94,9435,PAPUA,INTAN JAYA,119,119,0,119,0,0,1,2,3,8,5,16,4,8,10,0,0,6,13,20,18,0,0,25,27,0,5,0,34,23,57,57
2017,11,94,9436,PAPUA,DEIYAI,0,0,0,0,0,0,0,0,0,0,0,0,0,0,0,0,0,0,0,0,0,0,0,0,0,0,0,0,0,0,0,0
2017,12,91,9101,PAPUA BARAT,FAKFAK,432,424,373,51,0,0,0,1,0,1,1,1,0,5,2,0,0,1,2,1,7,0,0,8,2,0,1,0,8,3,11,11
2017,12,91,9102,PAPUA BARAT,KAIMANA,112,112,112,0,0,0,0,1,4,1,1,0,0,1,1,0,0,5,2,0,2,0,0,5,4,0,0,0,3,6,9,9
2017,12,91,9103,PAPUA BARAT,TELUK WONDAMA,1149,1144,1114,30,0,1,2,11,13,15,8,10,3,21,19,0,0,27,23,13,40,0,0,63,40,0,0,0,58,45,103,103
2017,12,91,9104,PAPUA BARAT,TELUK BINTUNI,0,0,0,0,0,0,0,0,0,0,0,0,0,0,0,0,0,0,0,0,0,0,0,0,0,0,0,0,0,0,0,0
2017,12,91,9105,PAPUA BARAT,MANOKWARI,624,957,762,195,0,11,15,83,51,38,41,51,16,103,80,0,0,160,79,67,183,0,0,50,410,0,9,0,286,203,489,469
2017,12,91,9106,PAPUA BARAT,SORONG SELATAN,364,364,290,74,0,1,0,0,0,0,0,1,0,1,1,0,0,1,0,1,2,0,0,1,3,0,0,0,3,1,4,4
2017,12,91,9107,PAPUA BARAT,SORONG,175,175,2,173,0,0,0,0,0,2,1,0,0,0,0,0,0,0,3,0,0,0,0,0,0,0,3,0,2,1,3,3
2017,12,91,9108,PAPUA BARAT,RAJA AMPAT,0,0,0,0,0,0,0,0,0,0,0,0,0,0,0,0,0,0,0,0,0,0,0,0,0,0,0,0,0,0,0,0
2017,12,91,9109,PAPUA BARAT,TAMBRAUW,0,0,0,0,0,0,0,0,0,0,0,0,0,0,0,0,0,0,0,0,0,0,0,0,0,0,0,0,0,0,0,0
2017,12,91,9110,PAPUA BARAT,MAYBRAT,0,0,0,0,0,0,0,0,0,0,0,0,0,0,0,0,0,0,0,0,0,0,0,0,0,0,0,0,0,0,0,0
2017,12,91,9111,PAPUA BARAT,MANOKWARI SELATAN,437,437,428,9,0,1,0,4,3,6,2,6,2,15,11,0,0,8,8,8,26,0,0,37,12,0,1,0,32,18,50,50
2017,12,91,9112,PAPUA BARAT,PEGUNUNGAN ARFAK,0,0,0,0,0,0,0,0,0,0,0,0,0,0,0,0,0,0,0,0,0,0,0,0,0,0,0,0,0,0,0,0
2017,12,91,9171,PAPUA BARAT,KOTA SORONG,0,0,0,0,0,0,0,0,0,0,0,0,0,0,0,0,0,0,0,0,0,0,0,0,0,0,0,0,0,0,0,0
2017,12,94,9471,PAPUA,KOTA JAYAPURA,4931,4931,4095,836,0,2,5,59,84,60,71,68,51,479,315,0,0,150,131,119,794,0,1,631,463,15,85,0,668,526,1194,1194
2017,12,94,9403,PAPUA,JAYAPURA,1588,1682,1123,559,0,3,1,51,25,51,34,35,13,220,106,0,0,80,85,48,326,0,0,340,140,4,55,0,360,179,539,539
2017,12,94,9420,PAPUA,KEEROM,1014,1014,731,283,0,7,6,69,58,72,67,56,44,358,264,8,5,140,139,100,622,13,9,586,314,6,108,0,570,444,1014,1014
2017,12,94,9419,PAPUA,SARMI,1213,1213,1213,0,0,4,2,86,82,106,73,76,71,367,218,0,0,174,179,147,585,0,6,609,420,14,42,0,639,446,1085,1085
2017,12,94,9409,PAPUA,BIAK NUMFOR,299,299,150,149,0,1,0,1,2,4,1,0,0,6,3,0,0,4,5,0,9,0,1,7,7,0,4,0,12,6,18,18
2017,12,94,9427,PAPUA,SUPIORI,0,0,0,0,0,0,0,0,0,0,0,0,0,0,0,0,0,0,0,0,0,0,0,0,0,0,0,0,0,0,0,0
2017,12,94,9401,PAPUA,MERAUKE,1531,1531,1473,58,0,14,11,70,54,52,49,23,25,192,126,5,2,149,101,48,318,7,0,209,394,5,15,0,356,267,623,623
2017,12,94,9414,PAPUA,MAPPI,1912,1912,1447,465,0,11,7,47,34,43,40,12,18,70,47,183,146,99,83,30,117,329,2,232,366,0,60,0,366,292,658,658
2017,12,94,9413,PAPUA,BOVEN DIGOEL,656,492,203,289,0,10,5,90,72,53,58,23,17,103,71,3,0,177,111,40,174,3,0,242,141,0,122,0,282,223,505,505
2017,12,94,9404,PAPUA,NABIRE,6201,6201,5065,1136,0,1,1,13,19,11,7,12,14,64,49,0,0,34,18,26,113,0,0,151,35,0,5,0,101,90,191,191
2017,12,94,9408,PAPUA,KEPULAUAN YAPEN,1447,1408,1300,108,0,35,29,84,81,47,42,18,20,140,231,10,12,229,89,38,371,22,17,585,148,0,16,0,334,415,749,749
2017,12,94,9412,PAPUA,MIMIKA,0,0,0,0,0,0,0,0,0,0,0,0,0,0,0,0,0,0,0,0,0,0,0,0,0,0,0,0,0,0,0,0
2017,12,94,9410,PAPUA,PANIAI,219,219,68,151,0,1,0,4,5,4,1,4,4,17,16,2,0,10,5,8,33,2,0,26,32,0,0,0,32,26,58,58
2017,12,94,9415,PAPUA,ASMAT,87,83,0,83,0,0,0,3,5,11,9,1,2,9,4,0,0,8,20,3,13,0,2,16,9,0,19,0,24,20,44,44
2017,12,94,9426,PAPUA,WAROPEN,437,437,437,0,0,14,15,50,43,31,28,13,12,98,116,12,7,122,59,25,214,19,0,436,3,0,0,0,218,221,439,439
2017,12,94,9402,PAPUA,JAYAWIJAYA,21,21,18,3,0,0,0,0,0,1,1,1,1,11,6,0,0,0,2,2,17,0,3,7,14,0,0,0,13,8,21,21
2017,12,94,9411,PAPUA,PUNCAK JAYA,4,4,4,0,0,0,0,0,0,0,0,0,0,3,1,0,0,0,0,0,4,0,0,3,1,0,0,0,3,1,4,4
2017,12,94,9418,PAPUA,TOLIKARA,0,0,0,0,0,0,0,0,0,0,0,0,0,0,0,0,0,0,0,0,0,0,0,0,0,0,0,0,0,0,0,0
2017,12,94,9416,PAPUA,YAHUKIMO,0,0,0,0,0,0,0,0,0,0,0,0,0,0,0,0,0,0,0,0,0,0,0,0,0,0,0,0,0,0,0,0
2017,12,94,9417,PAPUA,PEGUNUNGAN BINTANG,0,0,0,0,0,0,0,0,0,0,0,0,0,0,0,0,0,0,0,0,0,0,0,0,0,0,0,0,0,0,0,0
2017,12,94,9428,PAPUA,MAMBERAMO RAYA,0,0,0,0,0,0,0,0,0,0,0,0,0,0,0,0,0,0,0,0,0,0,0,0,0,0,0,0,0,0,0,0
2017,12,94,9429,PAPUA,NDUGA,11,22,14,8,0,0,0,0,0,0,0,2,1,3,3,0,4,0,0,3,6,4,0,7,6,0,0,0,5,8,13,13
2017,12,94,9430,PAPUA,LANNY JAYA,0,0,0,0,0,0,0,0,0,0,0,0,0,0,0,0,0,0,0,0,0,0,0,0,0,0,0,0,0,0,0,0
2017,12,94,9431,PAPUA,MAMBERAMO TENGAH,0,0,0,0,0,0,0,0,0,0,0,0,0,0,0,0,0,0,0,0,0,0,0,0,0,0,0,0,0,0,0,0
2017,12,94,9432,PAPUA,YALIMO,379,379,379,0,0,0,1,8,3,8,9,5,3,56,26,0,0,12,17,8,82,0,0,66,51,0,2,0,77,42,119,119
2017,12,94,9433,PAPUA,PUNCAK,0,0,0,0,0,0,0,0,0,0,0,0,0,0,0,0,0,0,0,0,0,0,0,0,0,0,0,0,0,0,0,0
2017,12,94,9434,PAPUA,DOGIYAI,0,0,0,0,0,0,0,0,0,0,0,0,0,0,0,0,0,0,0,0,0,0,0,0,0,0,0,0,0,0,0,0
2017,12,94,9435,PAPUA,INTAN JAYA,0,0,0,0,0,0,0,0,0,0,0,0,0,0,0,0,0,0,0,0,0,0,0,0,0,0,0,0,0,0,0,0
2017,12,94,9436,PAPUA,DEIYAI,0,0,0,0,0,0,0,0,0,0,0,0,0,0,0,0,0,0,0,0,0,0,0,0,0,0,0,0,0,0,0,0
2014,1,94,9499,PAPUA,HOSPITAL,1515,0,1496,19,0,0,0,0,0,0,0,0,0,0,0,0,0,0,0,0,0,0,0,0,0,0,0,0,0,0,0,0
2014,2,94,9499,PAPUA,HOSPITAL,1180,1180,1167,13,0,11,7,95,63,74,48,25,16,317,290,0,0,176,122,41,607,0,0,1567,354,0,64,0,522,424,946,1985
2014,3,94,9499,PAPUA,HOSPITAL,4234,0,4230,4,0,1,27,159,167,135,137,85,86,511,503,0,0,354,272,171,1014,0,0,2350,669,0,88,0,891,920,1811,3107
2014,4,94,9499,PAPUA,HOSPITAL,3861,0,3853,8,0,33,31,115,109,47,52,26,22,414,552,0,0,288,99,48,966,0,0,1150,316,5,23,0,635,766,1401,1494
2014,5,94,9499,PAPUA,HOSPITAL,4728,0,4723,5,0,20,27,136,116,107,98,73,69,460,361,0,0,299,205,142,821,0,0,1040,392,7,30,0,796,671,1467,1469
2014,6,94,9499,PAPUA,HOSPITAL,3022,0,2914,108,0,80,54,175,219,93,85,45,44,729,764,0,0,528,178,89,1493,0,0,1220,304,1,12,0,1122,1166,2288,1537
2014,7,94,9499,PAPUA,HOSPITAL,5961,0,5813,148,0,103,86,339,282,223,187,123,109,1226,1099,0,0,810,410,232,2325,0,0,2617,1897,0,29,0,2014,1763,3777,4543
2014,8,94,9499,PAPUA,HOSPITAL,5529,0,5405,124,0,111,104,319,274,218,185,102,113,889,1075,0,0,808,403,215,1964,0,0,2342,1326,8,39,0,1639,1751,3390,3715
2014,9,94,9499,PAPUA,HOSPITAL,2482,0,2389,93,0,53,66,191,213,77,66,53,42,473,939,0,0,523,143,95,1412,0,0,1575,685,0,4,0,847,1326,2173,2264
2014,10,94,9499,PAPUA,HOSPITAL,2214,2214,2213,1,0,39,43,140,136,70,58,31,48,491,531,0,0,358,128,79,1022,0,0,1893,316,0,1,0,771,816,1587,2210
2014,11,94,9499,PAPUA,HOSPITAL,610,0,599,6,0,23,29,81,56,28,28,13,22,87,143,0,0,189,56,35,230,0,0,475,34,1,1,0,232,278,510,511
2014,12,94,9499,PAPUA,HOSPITAL,0,0,0,0,0,0,0,0,0,0,0,0,0,0,0,0,0,0,0,0,0,0,0,0,0,0,0,0,0,0,0,0
2015,1,94,9499,PAPUA,HOSPITAL,2629,2217,2215,2,0,34,31,62,77,92,75,67,72,251,223,0,0,204,167,139,474,0,0,742,223,0,3,0,506,478,984,968
2015,2,94,9499,PAPUA,HOSPITAL,1655,1655,1655,0,0,9,10,46,28,33,26,22,34,102,92,0,0,93,59,56,194,0,0,376,262,0,0,0,212,190,402,638
2015,3,94,9499,PAPUA,HOSPITAL,0,0,0,0,0,0,0,0,0,0,0,0,0,0,0,0,0,0,0,0,0,0,0,0,0,0,0,0,0,0,0,0
2015,4,94,9499,PAPUA,HOSPITAL,0,0,0,0,0,0,0,0,0,0,0,0,0,0,0,0,0,0,0,0,0,0,0,0,0,0,0,0,0,0,0,0
2015,5,94,9499,PAPUA,HOSPITAL,3216,3216,3198,18,0,35,31,174,145,109,121,76,56,345,349,0,0,385,230,132,694,0,0,636,791,1,15,0,739,702,1441,1443
2015,6,94,9499,PAPUA,HOSPITAL,137,137,137,0,0,1,3,3,5,1,0,1,2,11,10,0,0,12,1,3,21,0,0,6,31,0,0,0,17,20,37,37
2015,7,94,9499,PAPUA,HOSPITAL,0,0,0,0,0,0,0,0,0,0,0,0,0,0,0,0,0,0,0,0,0,0,0,0,0,0,0,0,0,0,0,0
2015,8,94,9499,PAPUA,HOSPITAL,0,0,0,0,0,0,0,0,0,0,0,0,0,0,0,0,0,0,0,0,0,0,0,0,0,0,0,0,0,0,0,0
2015,9,94,9499,PAPUA,HOSPITAL,0,0,0,0,0,0,0,0,0,0,0,0,0,0,0,0,0,0,0,0,0,0,0,0,0,0,0,0,0,0,0,0
2015,10,94,9499,PAPUA,HOSPITAL,0,0,0,0,0,0,0,0,0,0,0,0,0,0,0,0,0,0,0,0,0,0,0,0,0,0,0,0,0,0,0,0
2015,11,94,9499,PAPUA,HOSPITAL,0,0,0,0,0,0,0,0,0,0,0,0,0,0,0,0,0,0,0,0,0,0,0,0,0,0,0,0,0,0,0,0
2015,12,94,9499,PAPUA,HOSPITAL,0,0,0,0,0,0,0,0,0,0,0,0,0,0,0,0,0,0,0,0,0,0,0,0,0,0,0,0,0,0,0,0
2019,1,91,9101,PAPUA BARAT,FAKFAK,2123,2413,2238,175,0,1,0,3,0,1,0,1,0,12,0,1,0,4,1,1,12,1,0,15,4,0,0,0,15,4,19,19
2019,1,91,9102,PAPUA BARAT,KAIMANA,351,425,323,102,0,1,0,0,0,0,0,0,0,10,0,0,0,1,0,0,10,0,0,4,6,0,1,0,10,1,11,11
2019,1,91,9103,PAPUA BARAT,TELUK WONDAMA,629,912,649,263,0,1,0,10,0,17,0,4,0,42,0,0,0,11,17,4,42,0,0,45,27,0,2,0,46,28,74,74
2019,1,91,9104,PAPUA BARAT,TELUK BINTUNI,378,559,413,146,0,0,0,1,0,2,0,0,0,7,0,1,0,1,2,0,7,1,0,4,6,0,1,0,9,2,11,11
2019,1,91,9105,PAPUA BARAT,MANOKWARI,5054,5330,4797,533,0,9,0,84,0,54,0,42,0,180,0,6,0,93,54,42,180,6,0,155,203,0,22,0,222,153,375,380
2019,1,91,9106,PAPUA BARAT,SORONG SELATAN,399,459,364,95,0,0,0,0,0,0,0,0,0,3,0,0,0,0,0,0,3,0,0,1,2,0,0,0,1,2,3,3
2019,1,91,9107,PAPUA BARAT,SORONG,725,931,249,682,0,0,0,2,0,0,0,0,0,5,0,0,0,2,0,0,5,0,0,1,6,0,1,0,7,0,7,8
2019,1,91,9108,PAPUA BARAT,RAJA AMPAT,187,208,102,106,0,0,0,3,0,4,0,2,0,7,0,0,0,3,4,2,7,0,0,8,5,0,3,0,9,7,16,16
2019,1,91,9109,PAPUA BARAT,TAMBRAUW,60,102,38,64,0,0,0,11,0,6,0,2,0,22,0,0,0,11,6,2,22,0,0,24,10,0,7,0,20,21,41,41
2019,1,91,9110,PAPUA BARAT,MAYBRAT,5,5,5,0,0,0,0,0,0,0,0,0,0,0,0,0,0,0,0,0,0,0,0,0,0,0,0,0,0,0,0,0
2019,1,91,9111,PAPUA BARAT,MANOKWARI SELATAN,633,688,675,13,0,1,0,7,0,6,0,6,0,56,0,0,0,8,6,6,56,0,0,34,39,0,3,0,41,35,76,76
2019,1,91,9112,PAPUA BARAT,PEGUNUNGAN ARFAK,0,0,0,0,0,0,0,0,0,0,0,0,0,0,0,0,0,0,0,0,0,0,0,0,0,0,0,0,0,0,0,0
2019,1,91,9171,PAPUA BARAT,KOTA SORONG,821,966,648,318,0,0,0,6,0,7,0,4,0,35,0,0,0,6,7,4,35,0,0,19,26,0,7,0,39,13,52,52
2019,1,94,9401,PAPUA,MERAUKE,3033,3259,2894,365,0,19,0,83,0,57,0,49,0,340,0,12,0,102,57,49,340,12,0,135,419,1,6,0,324,236,560,561
2019,1,94,9402,PAPUA,JAYAWIJAYA,883,1012,970,42,0,0,0,4,0,3,0,2,0,73,0,1,0,4,3,2,73,1,0,43,38,1,1,0,44,39,83,83
2019,1,94,9403,PAPUA,JAYAPURA,8512,9137,7794,1343,0,29,0,269,0,348,0,264,0,864,0,19,0,298,348,264,864,19,0,1085,428,41,238,1,933,860,1793,1793
2019,1,94,9404,PAPUA,NABIRE,3041,3327,2972,355,0,6,0,46,0,48,0,17,0,98,0,0,0,52,48,17,98,0,0,141,49,0,26,0,113,102,215,216
2019,1,94,9408,PAPUA,KEPULAUAN YAPEN,1137,1498,1449,49,0,44,0,195,0,92,0,36,0,292,0,9,0,239,92,36,292,9,0,578,68,0,14,0,279,389,668,660
2019,1,94,9409,PAPUA,BIAK NUMFOR,4268,4490,4187,303,0,0,0,8,0,11,0,6,0,24,0,0,0,8,11,6,24,0,0,18,24,0,7,0,28,21,49,49
2019,1,94,9410,PAPUA,PANIAI,261,262,114,148,0,1,0,2,0,2,0,1,0,22,0,0,0,3,2,1,22,0,0,23,5,0,0,0,14,14,28,28
2019,1,94,9411,PAPUA,PUNCAK JAYA,0,164,163,1,0,0,0,2,0,1,0,1,0,15,0,0,0,2,1,1,15,0,0,16,3,0,0,0,10,9,19,19
2019,1,94,9412,PAPUA,MIMIKA,15469,16898,15579,1319,0,77,0,603,0,584,0,492,0,3277,0,33,0,680,584,492,3277,33,0,2132,2659,99,176,0,2896,2170,5066,5066
2019,1,94,9413,PAPUA,BOVEN DIGOEL,2009,2398,1635,763,0,33,0,163,0,102,0,57,0,367,0,14,0,196,102,57,367,14,0,442,186,1,107,0,398,338,736,736
2019,1,94,9414,PAPUA,MAPPI,1956,2331,1549,782,0,6,0,39,0,14,0,8,0,63,0,0,0,45,14,8,63,0,0,70,43,0,17,0,69,61,130,130
2019,1,94,9415,PAPUA,ASMAT,1865,2215,1126,1089,0,49,0,342,0,185,0,76,0,493,0,0,0,391,185,76,493,0,0,563,296,0,287,0,647,498,1145,1146
2019,1,94,9416,PAPUA,YAHUKIMO,551,549,549,0,0,5,0,20,0,17,0,15,0,67,0,0,0,25,17,15,67,0,0,55,62,0,7,0,66,58,124,124
2019,1,94,9417,PAPUA,PEGUNUNGAN BINTANG,92,94,70,24,0,1,0,4,0,6,0,6,0,65,0,0,0,5,6,6,65,0,0,41,38,0,3,0,65,17,82,82
2019,1,94,9418,PAPUA,TOLIKARA,0,0,0,0,0,0,0,0,0,0,0,0,0,0,0,0,0,0,0,0,0,0,0,0,0,0,0,0,0,0,0,0
2019,1,94,9419,PAPUA,SARMI,2534,3302,2952,350,0,17,0,201,0,272,0,156,0,727,0,11,0,218,272,156,727,11,0,887,368,17,118,0,763,621,1384,1390
2019,1,94,9420,PAPUA,KEEROM,3580,5506,4908,598,0,18,0,273,0,320,0,201,0,1028,0,445,0,291,320,201,1028,445,0,1390,702,30,169,0,1273,1012,2285,2291
2019,1,94,9426,PAPUA,WAROPEN,0,825,825,0,0,27,0,96,0,59,0,39,0,179,0,11,0,123,59,39,179,11,0,411,0,0,0,0,182,229,411,411
2019,1,94,9427,PAPUA,SUPIORI,244,245,105,140,0,0,0,0,0,0,0,0,0,3,0,0,0,0,0,0,3,0,0,0,3,0,0,0,1,2,3,3
2019,1,94,9428,PAPUA,MAMBERAMO RAYA,29,81,38,43,0,3,0,14,0,10,0,2,0,21,0,0,0,17,10,2,21,0,0,46,4,0,0,0,21,29,50,50
2019,1,94,9429,PAPUA,NDUGA,0,4,4,0,0,0,0,2,0,0,0,0,0,6,0,0,0,2,0,0,6,0,0,2,6,0,0,0,8,0,8,8
2019,1,94,9430,PAPUA,LANNY JAYA,0,34,0,34,0,0,0,0,0,0,0,0,0,1,0,0,0,0,0,0,1,0,0,0,0,0,1,0,0,1,1,1
2019,1,94,9431,PAPUA,MAMBERAMO TENGAH,0,16,0,16,0,0,0,2,0,0,0,0,0,6,0,0,0,2,0,0,6,0,0,5,0,0,3,0,4,4,8,8
2019,1,94,9432,PAPUA,YALIMO,113,113,112,1,0,0,0,1,0,0,0,0,0,25,0,0,0,1,0,0,25,0,0,12,13,0,1,0,20,6,26,26
2019,1,94,9433,PAPUA,PUNCAK,0,20,0,20,0,0,0,0,0,0,0,0,0,11,0,0,0,0,0,0,11,0,0,1,6,0,4,0,8,3,11,11
2019,1,94,9434,PAPUA,DOGIYAI,0,0,0,0,0,0,0,0,0,0,0,0,0,0,0,0,0,0,0,0,0,0,0,0,0,0,0,0,0,0,0,0
2019,1,94,9435,PAPUA,INTAN JAYA,0,72,0,72,0,1,0,1,0,2,0,2,0,5,0,0,0,2,2,2,5,0,0,7,3,0,1,0,3,8,11,11
2019,1,94,9436,PAPUA,DEIYAI,0,7,7,0,0,0,0,0,0,1,0,0,0,5,0,0,0,0,1,0,5,0,0,0,6,0,0,0,3,3,6,6
2019,1,94,9471,PAPUA,KOTA JAYAPURA,6153,9448,9046,402,0,21,0,161,0,213,0,195,0,1707,0,34,0,182,213,195,1707,34,0,1184,980,18,153,0,1490,841,2331,2335
2019,2,91,9101,PAPUA BARAT,FAKFAK,2856,3332,3097,235,0,0,0,2,0,1,0,0,0,11,0,0,0,2,1,0,11,0,0,10,5,0,0,0,8,6,14,15
2019,2,91,9102,PAPUA BARAT,KAIMANA,419,510,372,138,0,0,0,3,0,2,0,0,0,11,0,0,0,3,2,0,11,0,0,14,1,0,1,0,13,3,16,16
2019,2,91,9103,PAPUA BARAT,TELUK WONDAMA,529,783,527,256,0,0,0,24,0,15,0,11,0,38,0,0,0,24,15,11,38,0,0,52,29,0,7,0,53,35,88,88
2019,2,91,9104,PAPUA BARAT,TELUK BINTUNI,375,618,481,137,0,0,0,1,0,0,0,0,0,9,0,0,0,1,0,0,9,0,0,3,7,0,0,0,10,0,10,10
2019,2,91,9105,PAPUA BARAT,MANOKWARI,4823,5022,4453,569,0,7,0,62,0,61,0,37,0,183,0,3,0,69,61,37,183,3,0,130,197,0,28,0,191,162,353,355
2019,2,91,9106,PAPUA BARAT,SORONG SELATAN,359,406,287,119,0,1,0,0,0,0,0,0,0,2,0,0,0,1,0,0,2,0,0,0,3,0,0,0,3,0,3,3
2019,2,91,9107,PAPUA BARAT,SORONG,712,1127,381,746,0,0,0,1,0,5,0,1,0,10,0,1,0,1,5,1,10,1,0,5,10,0,4,0,12,6,18,19
2019,2,91,9108,PAPUA BARAT,RAJA AMPAT,200,216,113,103,0,1,0,6,0,2,0,1,0,6,0,0,0,7,2,1,6,0,0,9,7,0,0,0,11,5,16,16
2019,2,91,9109,PAPUA BARAT,TAMBRAUW,252,287,173,114,0,2,0,10,0,8,0,9,0,45,0,2,0,12,8,9,45,2,0,47,14,0,15,0,41,35,76,76
2019,2,91,9110,PAPUA BARAT,MAYBRAT,9,9,9,0,0,0,0,0,0,0,0,0,0,0,0,0,0,0,0,0,0,0,0,0,0,0,0,0,0,0,0,0
2019,2,91,9111,PAPUA BARAT,MANOKWARI SELATAN,640,666,662,4,0,0,0,8,0,11,0,6,0,57,0,0,0,8,11,6,57,0,0,40,36,0,6,0,54,28,82,82
2019,2,91,9112,PAPUA BARAT,PEGUNUNGAN ARFAK,0,0,0,0,0,0,0,0,0,0,0,0,0,0,0,0,0,0,0,0,0,0,0,0,0,0,0,0,0,0,0,0
2019,2,91,9171,PAPUA BARAT,KOTA SORONG,652,957,603,354,0,0,0,2,0,2,0,6,0,39,0,3,0,2,2,6,39,3,0,14,36,0,2,0,32,20,52,52
2019,2,94,9401,PAPUA,MERAUKE,2983,3170,2781,389,0,14,0,74,0,46,0,39,0,261,0,5,0,88,46,39,261,5,0,105,326,0,8,0,253,186,439,439
2019,2,94,9402,PAPUA,JAYAWIJAYA,804,969,818,151,0,0,0,2,0,3,0,1,0,68,0,3,0,2,3,1,68,3,0,30,44,1,2,0,50,27,77,77
2019,2,94,9403,PAPUA,JAYAPURA,9079,9729,8264,1465,0,18,0,278,0,393,0,311,0,1028,0,32,0,296,393,311,1028,32,0,1332,439,43,247,0,1094,966,2060,2061
2019,2,94,9404,PAPUA,NABIRE,3555,4005,3651,354,0,7,0,31,0,32,0,20,0,128,0,5,0,38,32,20,128,5,0,138,67,0,24,0,131,92,223,229
2019,2,94,9408,PAPUA,KEPULAUAN YAPEN,555961,1573,1400,173,0,49,0,274,0,120,0,55,0,284,0,14,0,323,120,55,284,14,0,693,87,0,16,0,324,472,796,796
2019,2,94,9409,PAPUA,BIAK NUMFOR,3697,3878,3647,231,0,0,0,1,0,4,0,1,0,21,0,0,0,1,4,1,21,0,0,6,14,0,7,0,19,8,27,27
2019,2,94,9410,PAPUA,PANIAI,273,273,144,129,0,1,0,4,0,4,0,3,0,9,0,0,0,5,4,3,9,0,0,11,10,0,0,0,12,9,21,21
2019,2,94,9411,PAPUA,PUNCAK JAYA,0,155,155,0,0,0,0,2,0,2,0,2,0,19,0,0,0,2,2,2,19,0,0,22,3,0,0,0,12,13,25,25
2019,2,94,9412,PAPUA,MIMIKA,17026,18227,17319,908,0,69,0,605,0,634,0,466,0,3094,0,29,0,674,634,466,3094,29,0,2198,2360,110,229,0,2803,2094,4897,4897
2019,2,94,9413,PAPUA,BOVEN DIGOEL,1782,2044,1431,613,0,27,0,148,0,94,0,61,0,334,0,12,0,175,94,61,334,12,0,394,175,0,107,0,353,323,676,676
2019,2,94,9414,PAPUA,MAPPI,1856,2254,1426,828,0,3,0,31,0,22,0,8,0,57,0,1,0,34,22,8,57,1,0,85,26,0,11,0,58,64,122,122
2019,2,94,9415,PAPUA,ASMAT,3315,3331,2219,1112,0,45,0,381,0,170,0,88,0,584,0,9,0,426,170,88,584,9,0,675,308,0,294,0,724,553,1277,1277
2019,2,94,9416,PAPUA,YAHUKIMO,673,673,673,0,0,5,0,22,0,21,0,20,0,136,0,0,0,27,21,20,136,0,0,89,108,0,7,0,117,87,204,204
2019,2,94,9417,PAPUA,PEGUNUNGAN BINTANG,56,56,37,19,0,0,0,10,0,1,0,3,0,29,0,1,0,10,1,3,29,1,0,23,21,0,0,0,31,13,44,44
2019,2,94,9418,PAPUA,TOLIKARA,0,0,0,0,0,0,0,0,0,0,0,0,0,0,0,0,0,0,0,0,0,0,0,0,0,0,0,0,0,0,0,0
2019,2,94,9419,PAPUA,SARMI,2058,3016,2688,328,0,13,0,242,0,268,0,184,0,821,0,24,0,255,268,184,821,24,0,1035,407,27,89,0,842,710,1552,1558
2019,2,94,9420,PAPUA,KEEROM,3621,5363,5004,359,0,21,0,194,0,258,0,216,0,880,0,415,0,215,258,216,880,415,0,1271,560,39,115,0,1097,887,1984,1985
2019,2,94,9426,PAPUA,WAROPEN,0,373,373,0,0,17,0,38,0,49,0,16,0,86,0,5,0,55,49,16,86,5,0,211,0,0,0,0,100,111,211,211
2019,2,94,9427,PAPUA,SUPIORI,288,288,168,120,0,0,0,0,0,0,0,1,0,2,0,2,0,0,0,1,2,2,0,2,3,0,0,0,3,2,5,5
2019,2,94,9428,PAPUA,MAMBERAMO RAYA,215,268,226,42,0,6,0,29,0,31,0,6,0,74,0,1,0,35,31,6,74,1,0,144,1,0,2,0,72,75,147,147
2019,2,94,9429,PAPUA,NDUGA,0,10,8,2,0,0,0,0,0,0,0,0,0,18,0,0,0,0,0,0,18,0,0,4,14,0,0,0,11,7,18,18
2019,2,94,9430,PAPUA,LANNY JAYA,0,126,61,65,0,0,0,2,0,0,0,2,0,4,0,0,0,2,0,2,4,0,0,2,3,0,3,0,3,5,8,8
2019,2,94,9431,PAPUA,MAMBERAMO TENGAH,0,71,38,33,0,0,0,1,0,2,0,1,0,12,0,0,0,1,2,1,12,0,0,9,4,0,3,0,7,9,16,16
2019,2,94,9432,PAPUA,YALIMO,133,133,133,0,0,0,0,2,0,1,0,0,0,20,0,0,0,2,1,0,20,0,0,10,12,0,1,0,18,5,23,23
2019,2,94,9433,PAPUA,PUNCAK,0,34,0,34,0,0,0,2,0,1,0,1,0,18,0,0,0,2,1,1,18,0,0,9,9,0,4,0,14,8,22,22
2019,2,94,9434,PAPUA,DOGIYAI,0,0,0,0,0,0,0,0,0,0,0,0,0,0,0,0,0,0,0,0,0,0,0,0,0,0,0,0,0,0,0,0
2019,2,94,9435,PAPUA,INTAN JAYA,0,98,5,93,0,0,0,1,0,1,0,0,0,7,0,0,0,1,1,0,7,0,0,3,6,0,0,0,6,3,9,9
2019,2,94,9436,PAPUA,DEIYAI,0,25,19,6,0,0,0,2,0,1,0,2,0,6,0,0,0,2,1,2,6,0,0,1,10,0,0,0,4,7,11,11
2019,2,94,9471,PAPUA,KOTA JAYAPURA,6020,9584,9176,408,0,19,0,154,0,231,0,240,0,1807,0,49,0,173,231,240,1807,49,0,1402,976,19,103,0,1559,941,2500,2500
2019,3,91,9101,PAPUA BARAT,FAKFAK,1744,1993,1770,223,0,0,0,0,0,2,0,1,0,11,0,0,0,0,2,1,11,0,0,9,4,0,1,0,8,6,14,14
2019,3,91,9102,PAPUA BARAT,KAIMANA,590,692,572,120,0,0,0,5,0,7,0,6,0,14,0,0,0,5,7,6,14,0,0,28,4,0,0,0,20,12,32,32
2019,3,91,9103,PAPUA BARAT,TELUK WONDAMA,471,676,436,240,0,4,0,11,0,14,0,6,0,25,0,6,0,15,14,6,25,6,0,51,13,1,1,0,39,27,66,66
2019,3,91,9104,PAPUA BARAT,TELUK BINTUNI,305,606,466,140,0,0,0,2,0,4,0,0,0,3,0,0,0,2,4,0,3,0,0,0,9,0,0,0,5,4,9,9
2019,3,91,9105,PAPUA BARAT,MANOKWARI,4529,4649,4172,477,0,5,0,56,0,73,0,36,0,172,0,9,0,61,73,36,172,9,0,144,175,0,35,0,209,142,351,354
2019,3,91,9106,PAPUA BARAT,SORONG SELATAN,287,335,287,48,0,0,0,1,0,0,0,0,0,4,0,0,0,1,0,0,4,0,0,2,1,0,2,0,2,3,5,5
2019,3,91,9107,PAPUA BARAT,SORONG,724,1090,309,781,0,0,0,3,0,2,0,3,0,14,0,0,0,3,2,3,14,0,0,1,14,0,7,0,17,5,22,22
2019,3,91,9108,PAPUA BARAT,RAJA AMPAT,243,288,179,128,0,0,0,3,0,11,0,8,0,14,0,2,0,3,11,8,14,2,0,24,10,0,4,0,22,16,38,38
2019,3,91,9109,PAPUA BARAT,TAMBRAUW,188,219,122,84,13,2,0,7,0,8,0,8,0,37,0,1,0,9,8,8,37,1,0,42,8,1,12,0,36,27,63,63
2019,3,91,9110,PAPUA BARAT,MAYBRAT,47,48,13,35,0,0,0,0,0,0,0,0,0,1,0,0,0,0,0,0,1,0,0,1,0,0,0,0,1,0,1,1
2019,3,91,9111,PAPUA BARAT,MANOKWARI SELATAN,677,706,669,37,0,0,0,15,0,12,0,3,0,38,0,3,0,15,12,3,38,3,0,34,32,0,5,0,43,28,71,71
2019,3,91,9112,PAPUA BARAT,PEGUNUNGAN ARFAK,0,0,0,0,0,0,0,0,0,0,0,0,0,0,0,0,0,0,0,0,0,0,0,0,0,0,0,0,0,0,0,0
2019,3,91,9171,PAPUA BARAT,KOTA SORONG,741,993,693,300,0,0,0,3,0,4,0,8,0,41,0,2,0,3,4,8,41,2,0,20,36,0,2,0,41,17,58,58
2019,3,94,9401,PAPUA,MERAUKE,3131,3371,2948,423,0,12,0,84,0,60,0,37,0,246,0,14,0,96,60,37,246,14,0,97,352,0,4,0,249,204,453,453
2019,3,94,9402,PAPUA,JAYAWIJAYA,833,962,812,150,0,1,0,1,0,2,0,4,0,53,0,0,0,2,2,4,53,0,0,16,45,0,2,0,42,19,61,63
2019,3,94,9403,PAPUA,JAYAPURA,7783,9599,6985,2613,1,15,0,221,0,374,0,257,0,846,0,26,0,236,374,257,846,26,0,1079,331,25,303,1,917,822,1739,1739
2019,3,94,9404,PAPUA,NABIRE,4516,5064,4606,458,0,8,0,56,0,46,0,25,0,158,0,5,0,64,46,25,158,5,0,191,81,2,25,0,204,94,298,299
2019,3,94,9408,PAPUA,KEPULAUAN YAPEN,992,1424,1074,350,0,44,0,181,0,110,0,68,0,327,0,10,0,225,110,68,327,10,0,667,68,0,5,0,323,417,740,740
2019,3,94,9409,PAPUA,BIAK NUMFOR,3356,3615,3438,177,0,0,0,3,0,3,0,4,0,15,0,1,0,3,3,4,15,1,0,4,16,1,5,0,15,11,26,26
2019,3,94,9410,PAPUA,PANIAI,301,301,158,143,0,0,0,7,0,7,0,6,0,24,0,0,0,7,7,6,24,0,0,36,7,1,0,0,23,21,44,44
2019,3,94,9411,PAPUA,PUNCAK JAYA,0,117,117,0,0,1,0,2,0,0,0,0,0,12,0,0,0,3,0,0,12,0,0,13,4,0,0,0,8,7,15,17
2019,3,94,9412,PAPUA,MIMIKA,19924,22149,20790,1359,0,65,0,646,0,751,0,571,0,3702,0,37,0,711,751,571,3702,37,0,2701,2720,132,219,0,3193,2579,5772,5772
2019,3,94,9413,PAPUA,BOVEN DIGOEL,1646,2105,1410,695,0,18,0,107,0,98,0,58,0,278,0,11,0,125,98,58,278,11,0,315,152,0,103,0,311,259,570,570
2019,3,94,9414,PAPUA,MAPPI,1966,2428,1995,433,0,6,0,34,0,31,0,7,0,48,0,2,0,40,31,7,48,2,0,86,30,0,12,0,64,64,128,128
2019,3,94,9415,PAPUA,ASMAT,2574,2573,2065,508,0,29,0,179,0,139,0,46,0,540,0,2,0,208,139,46,540,2,0,483,292,1,160,0,512,423,935,936
2019,3,94,9416,PAPUA,YAHUKIMO,954,954,740,214,0,5,0,34,0,31,0,22,0,126,0,0,0,39,31,22,126,0,0,96,111,0,11,0,116,102,218,218
2019,3,94,9417,PAPUA,PEGUNUNGAN BINTANG,78,79,52,27,0,0,0,16,0,11,0,3,0,33,0,0,0,16,11,3,33,0,0,38,23,0,2,0,34,29,63,63
2019,3,94,9418,PAPUA,TOLIKARA,0,0,0,0,0,0,0,0,0,0,0,0,0,0,0,0,0,0,0,0,0,0,0,0,0,0,0,0,0,0,0,0
2019,3,94,9419,PAPUA,SARMI,2352,3044,2759,285,0,19,0,197,0,210,0,146,0,638,0,12,0,216,210,146,638,12,0,775,331,27,95,0,677,545,1222,1228
2019,3,94,9420,PAPUA,KEEROM,2840,4544,4337,207,0,8,0,159,0,175,0,142,0,676,0,358,0,167,175,142,676,358,0,909,495,26,80,0,850,668,1518,1510
2019,3,94,9426,PAPUA,WAROPEN,0,1090,1090,0,0,30,0,120,0,78,0,37,0,196,0,13,0,150,78,37,196,13,0,475,0,0,0,0,203,271,474,475
2019,3,94,9427,PAPUA,SUPIORI,314,314,188,126,0,0,0,0,0,2,0,0,0,3,0,0,0,0,2,0,3,0,0,1,4,0,0,0,2,3,5,5
2019,3,94,9428,PAPUA,MAMBERAMO RAYA,170,310,277,33,0,6,0,31,0,25,0,17,0,134,0,0,0,37,25,17,134,0,0,202,7,0,4,0,106,107,213,213
2019,3,94,9429,PAPUA,NDUGA,0,4,1,3,0,0,0,0,0,0,0,0,0,8,0,0,0,0,0,0,8,0,0,2,6,0,0,0,6,2,8,8
2019,3,94,9430,PAPUA,LANNY JAYA,0,92,42,50,0,0,0,0,0,1,0,1,0,12,0,1,0,0,1,1,12,1,0,10,1,0,4,0,12,3,15,15
2019,3,94,9431,PAPUA,MAMBERAMO TENGAH,0,82,44,38,0,0,0,2,0,0,0,5,0,13,0,0,0,2,0,5,13,0,0,16,1,0,3,0,9,11,20,20
2019,3,94,9432,PAPUA,YALIMO,172,173,163,10,0,0,0,6,0,5,0,5,0,43,0,0,0,6,5,5,43,0,0,22,37,0,0,0,43,16,59,59
2019,3,94,9433,PAPUA,PUNCAK,0,25,0,25,0,0,0,0,0,0,0,0,0,14,0,0,0,0,0,0,14,0,0,4,4,0,6,0,7,7,14,14
2019,3,94,9434,PAPUA,DOGIYAI,0,0,0,0,0,0,0,0,0,0,0,0,0,0,0,0,0,0,0,0,0,0,0,0,0,0,0,0,0,0,0,0
2019,3,94,9435,PAPUA,INTAN JAYA,0,141,5,136,0,1,0,2,0,0,0,3,0,9,0,0,0,3,0,3,9,0,0,1,12,0,2,0,6,9,15,15
2019,3,94,9436,PAPUA,DEIYAI,0,27,1,26,0,0,0,0,0,0,0,0,0,1,0,0,0,0,0,0,1,0,0,0,1,0,0,0,0,1,1,1
2019,3,94,9471,PAPUA,KOTA JAYAPURA,6457,9781,9302,479,0,13,0,161,0,227,0,224,0,1955,0,42,0,174,227,224,1955,42,0,1449,1005,21,154,0,1704,918,2622,2629
2019,4,91,9101,PAPUA BARAT,FAKFAK,1730,2096,1919,177,0,0,0,2,0,3,0,0,0,9,0,0,0,2,3,0,9,0,0,10,2,0,2,0,11,3,14,14
2019,4,91,9102,PAPUA BARAT,KAIMANA,361,443,292,151,0,0,0,2,0,0,0,1,0,7,0,0,0,2,0,1,7,0,0,7,3,0,0,0,7,3,10,10
2019,4,91,9103,PAPUA BARAT,TELUK WONDAMA,457,726,493,233,0,4,0,20,0,14,0,4,0,33,0,1,0,24,14,4,33,1,0,63,13,0,0,0,40,36,76,76
2019,4,91,9104,PAPUA BARAT,TELUK BINTUNI,334,500,326,174,0,0,0,1,0,0,0,0,0,5,0,0,0,1,0,0,5,0,0,2,3,0,1,0,4,2,6,6
2019,4,91,9105,PAPUA BARAT,MANOKWARI,4221,4347,4033,314,0,10,0,71,0,65,0,40,0,176,0,3,0,81,65,40,176,3,0,139,215,0,13,0,215,150,365,367
2019,4,91,9106,PAPUA BARAT,SORONG SELATAN,393,394,368,26,0,0,0,0,0,0,0,1,0,5,0,0,0,0,0,1,5,0,0,0,6,0,0,0,5,1,6,6
2019,4,91,9107,PAPUA BARAT,SORONG,678,1129,538,591,0,0,0,9,0,6,0,3,0,16,0,0,0,9,6,3,16,0,0,1,32,0,1,0,21,13,34,34
2019,4,91,9108,PAPUA BARAT,RAJA AMPAT,220,301,156,145,0,0,0,9,0,10,0,5,0,9,0,1,0,9,10,5,9,1,0,12,6,0,16,0,20,14,34,34
2019,4,91,9109,PAPUA BARAT,TAMBRAUW,321,368,247,99,22,0,0,18,0,25,0,10,0,54,0,3,0,18,25,10,54,3,0,91,5,0,14,0,68,42,110,110
2019,4,91,9110,PAPUA BARAT,MAYBRAT,39,42,6,26,10,0,0,0,0,0,0,0,0,0,0,0,0,0,0,0,0,0,0,0,0,0,0,0,0,0,0,0
2019,4,91,9111,PAPUA BARAT,MANOKWARI SELATAN,496,533,481,52,0,2,0,6,0,9,0,3,0,24,0,0,0,8,9,3,24,0,0,18,21,0,5,0,26,18,44,44
2019,4,91,9112,PAPUA BARAT,PEGUNUNGAN ARFAK,0,0,0,0,0,0,0,0,0,0,0,0,0,0,0,0,0,0,0,0,0,0,0,0,0,0,0,0,0,0,0,0
2019,4,91,9171,PAPUA BARAT,KOTA SORONG,560,742,490,252,0,0,0,1,0,5,0,2,0,20,0,0,0,1,5,2,20,0,0,13,13,1,1,0,16,12,28,28
2019,4,94,9401,PAPUA,MERAUKE,3210,3414,2995,419,0,10,0,54,0,51,0,27,0,204,0,4,0,64,51,27,204,4,0,105,240,0,6,0,215,135,350,351
2019,4,94,9402,PAPUA,JAYAWIJAYA,543,660,562,98,0,0,0,0,0,3,0,0,0,56,0,0,0,0,3,0,56,0,0,17,39,1,2,0,36,23,59,59
2019,4,94,9403,PAPUA,JAYAPURA,7903,8413,6724,1689,0,22,0,249,0,327,0,274,0,911,0,31,0,271,327,274,911,31,0,1215,369,21,211,0,945,869,1814,1816
2019,4,94,9404,PAPUA,NABIRE,4052,4410,4131,279,0,6,0,45,0,36,0,15,0,168,0,4,0,51,36,15,168,4,0,194,60,0,20,0,182,92,274,274
2019,4,94,9408,PAPUA,KEPULAUAN YAPEN,1815,2349,2055,294,0,49,0,161,0,94,0,56,0,229,0,9,0,210,94,56,229,9,0,532,64,0,2,0,251,347,598,598
2019,4,94,9409,PAPUA,BIAK NUMFOR,3299,3520,3319,201,0,0,0,4,0,1,0,1,0,16,0,0,0,4,1,1,16,0,0,9,13,0,0,0,14,8,22,22
2019,4,94,9410,PAPUA,PANIAI,411,411,250,161,0,0,0,7,0,5,0,3,0,15,0,0,0,7,5,3,15,0,0,27,3,0,0,0,19,11,30,30
2019,4,94,9411,PAPUA,PUNCAK JAYA,0,235,214,21,0,2,0,4,0,2,0,2,0,22,0,0,0,6,2,2,22,0,0,17,15,0,0,0,16,16,32,32
2019,4,94,9412,PAPUA,MIMIKA,21002,24601,23472,1129,0,102,0,796,0,926,0,658,0,4209,0,39,0,898,926,658,4209,39,0,3450,2937,131,212,0,3735,2995,6730,6730
2019,4,94,9413,PAPUA,BOVEN DIGOEL,1635,1888,1353,535,0,26,0,110,0,86,0,51,0,326,0,9,0,136,86,51,326,9,0,373,130,1,104,0,302,306,608,608
2019,4,94,9414,PAPUA,MAPPI,1863,2216,1625,591,0,1,0,24,0,15,0,8,0,56,0,0,0,25,15,8,56,0,0,71,12,0,21,0,48,56,104,104
2019,4,94,9415,PAPUA,ASMAT,2528,2540,2274,266,0,15,0,191,0,109,0,65,0,415,0,3,0,206,109,65,415,3,0,400,309,0,88,1,495,303,798,798
2019,4,94,9416,PAPUA,YAHUKIMO,1443,1443,848,595,0,7,0,50,0,30,0,24,0,173,0,0,0,57,30,24,173,0,0,133,131,0,20,0,155,129,284,284
2019,4,94,9417,PAPUA,PEGUNUNGAN BINTANG,48,48,34,14,0,0,0,7,0,5,0,4,0,31,0,0,0,7,5,4,31,0,0,27,19,0,1,0,36,11,47,47
2019,4,94,9418,PAPUA,TOLIKARA,0,0,0,0,0,0,0,0,0,0,0,0,0,0,0,0,0,0,0,0,0,0,0,0,0,0,0,0,0,0,0,0
2019,4,94,9419,PAPUA,SARMI,3050,3615,3426,189,0,15,0,223,0,262,0,159,0,632,0,12,0,238,262,159,632,12,0,860,329,22,96,0,723,580,1303,1307
2019,4,94,9420,PAPUA,KEEROM,3810,6063,5691,372,0,11,0,201,0,202,0,179,0,897,0,578,0,212,202,179,897,578,0,1397,543,27,109,0,1163,905,2068,2076
2019,4,94,9426,PAPUA,WAROPEN,0,423,398,25,0,14,0,49,0,50,0,19,0,99,0,4,0,63,50,19,99,4,0,216,13,0,6,0,101,134,235,235
2019,4,94,9427,PAPUA,SUPIORI,159,209,116,93,0,0,0,2,0,1,0,0,0,5,0,0,0,2,1,0,5,0,0,5,3,0,0,0,5,3,8,8
2019,4,94,9428,PAPUA,MAMBERAMO RAYA,165,1097,1038,59,0,26,0,236,0,192,0,81,0,469,0,5,0,262,192,81,469,5,0,787,200,0,23,0,537,472,1009,1010
2019,4,94,9429,PAPUA,NDUGA,0,0,0,0,0,0,0,0,0,0,0,0,0,0,0,0,0,0,0,0,0,0,0,0,0,0,0,0,0,0,0,0
2019,4,94,9430,PAPUA,LANNY JAYA,0,116,67,49,0,0,0,1,0,0,0,1,0,15,0,0,0,1,0,1,15,0,0,7,3,0,7,0,12,5,17,17
2019,4,94,9431,PAPUA,MAMBERAMO TENGAH,0,100,59,41,0,0,0,1,0,2,0,3,0,20,0,0,0,1,2,3,20,0,0,14,3,0,9,0,16,10,26,26
2019,4,94,9432,PAPUA,YALIMO,316,319,302,17,0,2,0,4,0,0,0,3,0,28,0,0,0,6,0,3,28,0,0,24,13,0,0,0,28,9,37,37
2019,4,94,9433,PAPUA,PUNCAK,0,33,0,33,0,0,0,1,0,0,0,0,0,22,0,0,0,1,0,0,22,0,0,2,8,0,13,0,13,10,23,23
2019,4,94,9434,PAPUA,DOGIYAI,0,0,0,0,0,0,0,0,0,0,0,0,0,0,0,0,0,0,0,0,0,0,0,0,0,0,0,0,0,0,0,0
2019,4,94,9435,PAPUA,INTAN JAYA,0,118,61,57,0,0,0,3,0,1,0,0,0,8,0,0,0,3,1,0,8,0,0,7,3,0,2,0,9,3,12,12
2019,4,94,9436,PAPUA,DEIYAI,0,51,14,37,0,0,0,0,0,1,0,2,0,9,0,0,0,0,1,2,9,0,0,1,11,0,0,0,5,7,12,12
2019,4,94,9471,PAPUA,KOTA JAYAPURA,6384,10619,10280,339,0,16,0,202,0,273,0,222,0,2013,0,42,0,218,273,222,2013,42,0,1610,1048,15,101,0,1749,1019,2768,2774
2019,5,91,9101,PAPUA BARAT,FAKFAK,2166,2476,2275,201,0,0,0,3,0,1,0,0,0,4,0,0,0,3,1,0,4,0,0,4,2,1,1,0,2,6,8,8
2019,5,91,9102,PAPUA BARAT,KAIMANA,342,410,274,136,0,0,0,2,0,3,0,2,0,13,0,1,0,2,3,2,13,1,0,8,13,0,0,0,16,5,21,21
2019,5,91,9103,PAPUA BARAT,TELUK WONDAMA,506,777,425,352,0,0,0,23,0,11,0,2,0,29,0,1,0,23,11,2,29,1,0,50,15,0,1,0,39,27,66,66
2019,5,91,9104,PAPUA BARAT,TELUK BINTUNI,255,385,199,186,0,0,0,1,0,0,0,0,0,8,0,0,0,1,0,0,8,0,0,3,5,1,0,0,7,2,9,9
2019,5,91,9105,PAPUA BARAT,MANOKWARI,4820,4886,4479,407,0,9,0,61,0,71,0,33,0,185,0,7,0,70,71,33,185,7,0,151,205,0,14,0,205,161,366,370
2019,5,91,9106,PAPUA BARAT,SORONG SELATAN,453,731,695,36,0,0,0,0,0,0,0,0,0,0,0,0,0,0,0,0,0,0,0,0,0,0,0,0,0,0,0,0
2019,5,91,9107,PAPUA BARAT,SORONG,687,1444,888,556,0,0,0,0,0,3,0,2,0,9,0,0,0,0,3,2,9,0,0,1,12,0,1,0,7,7,14,14
2019,5,91,9108,PAPUA BARAT,RAJA AMPAT,196,236,110,126,0,1,0,2,0,3,0,4,0,6,0,1,0,3,3,4,6,1,0,7,2,0,8,0,8,9,17,17
2019,5,91,9109,PAPUA BARAT,TAMBRAUW,228,309,198,111,0,5,0,12,0,20,0,8,0,35,0,1,0,17,20,8,35,1,0,58,8,0,15,0,39,42,81,81
2019,5,91,9110,PAPUA BARAT,MAYBRAT,56,59,2,57,0,0,0,0,0,0,0,0,0,0,0,0,0,0,0,0,0,0,0,0,0,0,0,0,0,0,0,0
2019,5,91,9111,PAPUA BARAT,MANOKWARI SELATAN,441,490,415,75,0,1,0,14,0,11,0,6,0,47,0,1,0,15,11,6,47,1,0,38,37,0,5,0,48,32,80,80
2019,5,91,9112,PAPUA BARAT,PEGUNUNGAN ARFAK,0,0,0,0,0,0,0,0,0,0,0,0,0,0,0,0,0,0,0,0,0,0,0,0,0,0,0,0,0,0,0,0
2019,5,91,9171,PAPUA BARAT,KOTA SORONG,665,844,709,135,0,0,0,3,0,3,0,0,0,19,0,1,0,3,3,0,19,1,0,6,19,0,1,0,16,10,26,26
2019,5,94,9401,PAPUA,MERAUKE,3981,4219,3730,489,0,4,0,63,0,49,0,34,0,205,0,5,0,67,49,34,205,5,0,78,279,0,3,0,218,142,360,360
2019,5,94,9402,PAPUA,JAYAWIJAYA,641,786,692,94,0,0,0,2,0,3,0,1,0,53,0,0,0,2,3,1,53,0,0,15,44,0,1,0,39,20,59,60
2019,5,94,9403,PAPUA,JAYAPURA,10068,12790,8410,4379,1,22,0,339,0,492,0,359,0,1284,0,37,0,361,492,359,1284,37,0,1654,481,35,364,0,1263,1270,2533,2534
2019,5,94,9404,PAPUA,NABIRE,5063,5608,5265,343,0,9,0,49,0,28,0,16,0,227,0,4,0,58,28,16,227,4,0,246,77,0,12,0,221,112,333,335
2019,5,94,9408,PAPUA,KEPULAUAN YAPEN,2306,3042,2814,228,0,39,0,183,0,182,0,91,0,306,0,11,0,222,182,91,306,11,0,732,69,0,11,0,363,449,812,812
2019,5,94,9409,PAPUA,BIAK NUMFOR,4219,4719,4330,389,0,0,0,6,0,7,0,7,0,34,0,0,0,6,7,7,34,0,0,22,29,0,3,0,31,23,54,54
2019,5,94,9410,PAPUA,PANIAI,234,234,139,95,0,1,0,2,0,3,0,1,0,16,0,0,0,3,3,1,16,0,0,19,4,0,0,0,7,16,23,23
2019,5,94,9411,PAPUA,PUNCAK JAYA,0,350,340,10,0,1,0,3,0,2,0,4,0,17,0,1,0,4,2,4,17,1,0,16,12,0,0,0,14,14,28,28
2019,5,94,9412,PAPUA,MIMIKA,24390,27079,26088,991,0,84,0,979,0,1041,0,758,0,4978,0,43,0,1063,1041,758,4978,43,0,4048,3418,167,250,0,4340,3543,7883,7883
2019,5,94,9413,PAPUA,BOVEN DIGOEL,2689,2909,2333,576,0,23,0,185,0,163,0,86,0,463,0,15,0,208,163,86,463,15,0,661,154,0,116,0,492,443,935,931
2019,5,94,9414,PAPUA,MAPPI,2042,2373,1908,465,0,7,0,26,0,22,0,11,0,43,0,0,0,33,22,11,43,0,0,91,11,0,7,0,63,46,109,109
2019,5,94,9415,PAPUA,ASMAT,2711,2714,2463,251,0,14,0,177,0,157,0,77,0,560,0,6,0,191,157,77,560,6,0,641,288,0,63,0,590,401,991,992
2019,5,94,9416,PAPUA,YAHUKIMO,1690,1690,1086,604,0,14,0,73,0,42,0,59,0,263,0,2,0,87,42,59,263,2,0,231,193,0,28,0,260,193,453,452
2019,5,94,9417,PAPUA,PEGUNUNGAN BINTANG,64,67,31,36,0,1,0,17,0,8,0,2,0,30,0,0,0,18,8,2,30,0,0,39,19,0,0,0,33,25,58,58
2019,5,94,9418,PAPUA,TOLIKARA,0,0,0,0,0,0,0,0,0,0,0,0,0,0,0,0,0,0,0,0,0,0,0,0,0,0,0,0,0,0,0,0
2019,5,94,9419,PAPUA,SARMI,2327,2909,2717,192,0,7,0,231,0,243,0,141,0,682,0,18,0,238,243,141,682,18,0,871,338,9,105,0,735,587,1322,1323
2019,5,94,9420,PAPUA,KEEROM,4071,6909,6426,483,0,12,0,183,0,253,0,161,0,933,0,481,0,195,253,161,933,481,0,1295,538,32,168,0,1098,925,2023,2033
2019,5,94,9426,PAPUA,WAROPEN,0,843,816,27,0,35,0,101,0,69,0,45,0,255,0,9,0,136,69,45,255,9,0,497,14,0,4,0,254,260,514,515
2019,5,94,9427,PAPUA,SUPIORI,1658,1723,1245,478,0,1,0,0,0,0,0,1,0,10,0,0,0,1,0,1,10,0,0,7,5,0,0,0,8,4,12,12
2019,5,94,9428,PAPUA,MAMBERAMO RAYA,121,1167,1129,38,0,41,0,279,0,213,0,79,0,480,0,5,0,320,213,79,480,5,0,986,106,0,5,0,576,521,1097,1097
2019,5,94,9429,PAPUA,NDUGA,0,0,0,0,0,0,0,0,0,0,0,0,0,0,0,0,0,0,0,0,0,0,0,0,0,0,0,0,0,0,0,0
2019,5,94,9430,PAPUA,LANNY JAYA,0,317,223,94,0,0,0,0,0,4,0,1,0,35,0,0,0,0,4,1,35,0,0,24,9,0,7,0,22,18,40,40
2019,5,94,9431,PAPUA,MAMBERAMO TENGAH,0,130,65,65,0,0,0,2,0,4,0,1,0,15,0,0,0,2,4,1,15,0,0,11,3,0,8,0,15,7,22,22
2019,5,94,9432,PAPUA,YALIMO,336,338,308,30,0,2,0,2,0,6,0,4,0,22,0,0,0,4,6,4,22,0,0,13,21,0,2,0,25,11,36,36
2019,5,94,9433,PAPUA,PUNCAK,0,17,0,17,0,0,0,0,0,0,0,0,0,11,0,0,0,0,0,0,11,0,0,2,4,0,5,0,7,4,11,11
2019,5,94,9434,PAPUA,DOGIYAI,6,6,0,6,0,0,0,0,0,0,0,0,0,0,0,0,0,0,0,0,0,0,0,0,0,0,0,0,0,0,0,0
2019,5,94,9435,PAPUA,INTAN JAYA,0,135,0,135,0,0,0,5,0,2,0,0,0,12,0,0,0,5,2,0,12,0,0,10,8,0,1,0,7,12,19,19
2019,5,94,9436,PAPUA,DEIYAI,0,41,13,28,0,0,0,2,0,2,0,0,0,9,0,0,0,2,2,0,9,0,0,1,10,0,2,0,8,5,13,13
2019,5,94,9471,PAPUA,KOTA JAYAPURA,6457,11512,10064,1448,0,14,0,229,0,319,0,279,0,2072,0,58,0,243,319,279,2072,58,0,1776,1031,16,150,0,1828,1143,2971,2973
2019,6,91,9101,PAPUA BARAT,FAKFAK,1850,2256,2090,166,0,0,0,0,0,1,0,1,0,6,0,0,0,0,1,1,6,0,0,8,0,0,0,0,7,1,8,8
2019,6,91,9102,PAPUA BARAT,KAIMANA,306,387,240,147,0,0,0,2,0,2,0,2,0,10,0,1,0,2,2,2,10,1,0,6,9,0,2,0,13,4,17,17
2019,6,91,9103,PAPUA BARAT,TELUK WONDAMA,329,527,249,278,0,2,0,12,0,7,0,2,0,14,0,2,0,14,7,2,14,2,0,29,8,0,2,0,14,25,39,39
2019,6,91,9104,PAPUA BARAT,TELUK BINTUNI,261,546,330,216,0,0,0,1,0,0,0,2,0,1,0,0,0,1,0,2,1,0,0,0,4,0,0,0,3,1,4,4
2019,6,91,9105,PAPUA BARAT,MANOKWARI,4203,4267,3901,366,0,13,0,54,0,41,0,31,0,147,0,8,0,67,41,31,147,8,0,122,154,0,21,0,171,123,294,297
2019,6,91,9106,PAPUA BARAT,SORONG SELATAN,243,1287,1157,130,0,0,0,0,0,1,0,0,0,0,0,0,0,0,1,0,0,0,0,0,2,0,0,0,0,1,1,2
2019,6,91,9107,PAPUA BARAT,SORONG,554,703,270,433,0,0,0,2,0,1,0,0,0,6,0,0,0,2,1,0,6,0,0,2,7,0,0,0,6,3,9,9
2019,6,91,9108,PAPUA BARAT,RAJA AMPAT,147,160,65,95,0,0,0,3,0,1,0,0,0,5,0,0,0,3,1,0,5,0,0,3,3,0,3,0,5,4,9,9
2019,6,91,9109,PAPUA BARAT,TAMBRAUW,153,224,64,160,0,0,0,15,0,17,0,4,0,26,0,0,0,15,17,4,26,0,0,26,13,0,23,0,33,29,62,62
2019,6,91,9110,PAPUA BARAT,MAYBRAT,33,42,0,42,0,0,0,0,0,0,0,0,0,1,0,0,0,0,0,0,1,0,0,0,0,1,0,0,0,1,1,1
2019,6,91,9111,PAPUA BARAT,MANOKWARI SELATAN,367,397,354,43,0,2,0,11,0,15,0,4,0,44,0,0,0,13,15,4,44,0,0,34,36,0,6,0,34,42,76,76
2019,6,91,9112,PAPUA BARAT,PEGUNUNGAN ARFAK,0,0,0,0,0,0,0,0,0,0,0,0,0,0,0,0,0,0,0,0,0,0,0,0,0,0,0,0,0,0,0,0
2019,6,91,9171,PAPUA BARAT,KOTA SORONG,673,849,482,367,0,0,0,2,0,5,0,2,0,24,0,2,0,2,5,2,24,2,0,7,26,0,3,0,28,7,35,36
2019,6,94,9401,PAPUA,MERAUKE,2317,2531,2009,522,0,3,0,31,0,28,0,13,0,187,0,5,0,34,28,13,187,5,0,62,201,1,3,0,187,80,267,267
2019,6,94,9402,PAPUA,JAYAWIJAYA,511,620,531,89,0,0,0,2,0,2,0,0,0,47,0,0,0,2,2,0,47,0,0,16,33,0,2,0,39,12,51,51
2019,6,94,9403,PAPUA,JAYAPURA,8179,8926,6724,2202,0,18,0,230,0,324,0,322,0,923,0,34,0,248,324,322,923,34,0,1145,385,47,276,0,983,868,1851,1853
2019,6,94,9404,PAPUA,NABIRE,4243,4541,4230,311,0,8,0,36,0,27,0,23,0,172,0,2,0,44,27,23,172,2,0,184,71,0,14,0,168,100,268,269
2019,6,94,9408,PAPUA,KEPULAUAN YAPEN,1009,1388,963,425,0,12,0,71,0,64,0,28,0,138,0,9,0,83,64,28,138,9,0,268,40,0,14,0,149,173,322,322
2019,6,94,9409,PAPUA,BIAK NUMFOR,3328,3545,3211,334,0,0,0,3,0,4,0,8,0,22,0,0,0,3,4,8,22,0,0,16,17,0,4,0,21,16,37,37
2019,6,94,9410,PAPUA,PANIAI,251,251,141,110,0,0,0,11,0,7,0,4,0,16,0,0,0,11,7,4,16,0,0,34,4,0,0,0,15,23,38,38
2019,6,94,9411,PAPUA,PUNCAK JAYA,0,303,301,2,0,1,0,8,0,1,0,3,0,16,0,0,0,9,1,3,16,0,0,22,7,0,0,0,13,16,29,29
2019,6,94,9412,PAPUA,MIMIKA,24155,25818,25106,712,0,99,0,974,0,1125,0,842,0,5862,0,55,0,1073,1125,842,5862,55,0,5062,3421,166,308,0,4966,3991,8957,8957
2019,6,94,9413,PAPUA,BOVEN DIGOEL,2532,3212,2405,807,0,21,0,152,0,125,0,53,0,381,0,10,0,173,125,53,381,10,0,467,156,1,108,0,443,299,742,732
2019,6,94,9414,PAPUA,MAPPI,2087,2390,1939,451,0,5,0,22,0,36,0,22,0,49,0,1,0,27,36,22,49,1,0,105,16,0,14,0,84,51,135,135
2019,6,94,9415,PAPUA,ASMAT,2317,2448,2190,258,0,19,0,188,0,108,0,40,0,442,0,2,0,207,108,40,442,2,0,488,250,1,61,0,443,356,799,800
2019,6,94,9416,PAPUA,YAHUKIMO,0,0,0,0,0,0,0,0,0,0,0,0,0,0,0,0,0,0,0,0,0,0,0,0,0,0,0,0,0,0,0,0
2019,6,94,9417,PAPUA,PEGUNUNGAN BINTANG,79,86,46,40,0,0,0,9,0,6,0,3,0,35,0,0,0,9,6,3,35,0,0,37,13,0,3,0,31,22,53,53
2019,6,94,9418,PAPUA,TOLIKARA,0,0,0,0,0,0,0,0,0,0,0,0,0,0,0,0,0,0,0,0,0,0,0,0,0,0,0,0,0,0,0,0
2019,6,94,9419,PAPUA,SARMI,1604,2648,2456,192,0,10,0,149,0,193,0,118,0,565,0,15,0,159,193,118,565,15,0,748,179,18,105,0,571,479,1050,1050
2019,6,94,9420,PAPUA,KEEROM,2236,4317,3821,496,0,3,0,155,0,154,0,143,0,703,0,350,0,158,154,143,703,350,0,953,360,15,183,0,774,734,1508,1511
2019,6,94,9426,PAPUA,WAROPEN,0,504,483,21,0,16,0,53,0,43,0,36,0,169,0,9,0,69,43,36,169,9,0,307,14,0,6,0,157,169,326,327
2019,6,94,9427,PAPUA,SUPIORI,194,347,175,172,0,0,0,0,0,2,0,5,0,8,0,0,0,0,2,5,8,0,0,3,8,2,2,0,8,7,15,15
2019,6,94,9428,PAPUA,MAMBERAMO RAYA,154,786,719,67,0,27,0,163,0,124,0,49,0,335,0,1,0,190,124,49,335,1,0,616,63,0,20,0,363,336,699,699
2019,6,94,9429,PAPUA,NDUGA,0,0,0,0,0,0,0,0,0,0,0,0,0,0,0,0,0,0,0,0,0,0,0,0,0,0,0,0,0,0,0,0
2019,6,94,9430,PAPUA,LANNY JAYA,0,144,96,48,0,0,0,1,0,2,0,1,0,20,0,0,0,1,2,1,20,0,0,10,5,0,9,0,22,2,24,24
2019,6,94,9431,PAPUA,MAMBERAMO TENGAH,0,8,5,3,0,0,0,0,0,0,0,0,0,1,0,0,0,0,0,0,1,0,0,1,0,0,0,0,1,0,1,1
2019,6,94,9432,PAPUA,YALIMO,286,287,284,3,0,1,0,3,0,1,0,2,0,28,0,0,0,4,1,2,28,0,0,19,15,0,1,0,24,11,35,35
2019,6,94,9433,PAPUA,PUNCAK,0,14,0,14,0,0,0,0,0,0,0,0,0,8,0,0,0,0,0,0,8,0,0,1,3,0,4,0,4,4,8,8
2019,6,94,9434,PAPUA,DOGIYAI,1,1,1,0,0,0,0,0,0,0,0,0,0,0,0,0,0,0,0,0,0,0,0,0,0,0,0,0,0,0,0,0
2019,6,94,9435,PAPUA,INTAN JAYA,0,44,0,44,0,0,0,0,0,0,0,0,0,8,0,0,0,0,0,0,8,0,0,5,2,0,1,0,3,5,8,8
2019,6,94,9436,PAPUA,DEIYAI,0,8,2,6,0,0,0,0,0,1,0,1,0,1,0,0,0,0,1,1,1,0,0,1,2,0,0,0,1,2,3,3
2019,6,94,9471,PAPUA,KOTA JAYAPURA,5028,8447,8121,326,0,14,0,191,0,311,0,247,0,2057,0,38,0,205,311,247,2057,38,0,1715,972,21,155,0,1769,1089,2858,2863
2019,7,91,9101,PAPUA BARAT,FAKFAK,2163,2868,2413,455,0,1,0,4,0,9,0,4,0,22,0,1,0,5,9,4,22,1,0,16,16,0,9,0,27,14,41,41
2019,7,91,9102,PAPUA BARAT,KAIMANA,482,1710,1481,229,0,1,0,13,0,15,0,7,0,21,0,0,0,14,15,7,21,0,0,25,9,0,23,0,27,30,57,57
2019,7,91,9103,PAPUA BARAT,TELUK WONDAMA,624,867,533,334,0,0,0,23,0,10,0,4,0,28,0,2,0,23,10,4,28,2,0,44,19,1,3,0,36,31,67,67
2019,7,91,9104,PAPUA BARAT,TELUK BINTUNI,339,782,559,223,0,0,0,1,0,0,0,0,0,9,0,1,0,1,0,0,9,1,0,0,10,0,1,0,8,3,11,11
2019,7,91,9105,PAPUA BARAT,MANOKWARI,5226,5897,5371,526,0,27,0,62,0,41,0,35,0,196,0,8,0,89,41,35,196,8,0,131,219,0,20,0,204,165,369,370
2019,7,91,9106,PAPUA BARAT,SORONG SELATAN,252,359,199,160,0,0,0,0,0,0,0,0,0,0,0,0,0,0,0,0,0,0,0,0,0,0,0,0,0,0,0,0
2019,7,91,9107,PAPUA BARAT,SORONG,576,858,321,537,0,0,0,0,0,2,0,3,0,4,0,0,0,0,2,3,4,0,0,5,3,0,1,0,6,3,9,9
2019,7,91,9108,PAPUA BARAT,RAJA AMPAT,178,207,92,115,0,0,0,2,0,5,0,2,0,15,0,0,0,2,5,2,15,0,0,10,6,0,8,0,11,13,24,24
2019,7,91,9109,PAPUA BARAT,TAMBRAUW,199,322,79,243,0,2,0,7,0,16,0,5,0,15,0,1,0,9,16,5,15,1,0,31,0,0,15,0,22,24,46,46
2019,7,91,9110,PAPUA BARAT,MAYBRAT,43,44,0,44,0,0,0,0,0,0,0,0,0,1,0,0,0,0,0,0,1,0,0,1,0,0,0,0,1,0,1,1
2019,7,91,9111,PAPUA BARAT,MANOKWARI SELATAN,502,523,510,13,0,2,0,14,0,7,0,8,0,26,0,0,0,16,7,8,26,0,0,25,28,0,4,0,34,23,57,57
2019,7,91,9112,PAPUA BARAT,PEGUNUNGAN ARFAK,0,0,0,0,0,0,0,0,0,0,0,0,0,0,0,0,0,0,0,0,0,0,0,0,0,0,0,0,0,0,0,0
2019,7,91,9171,PAPUA BARAT,KOTA SORONG,1165,1317,777,540,0,0,0,3,0,13,0,5,0,31,0,2,0,3,13,5,31,2,0,13,33,0,8,0,26,28,54,54
2019,7,94,9401,PAPUA,MERAUKE,2131,3356,1616,1740,0,3,0,28,0,20,0,14,0,132,0,1,0,31,20,14,132,1,0,29,159,0,10,0,134,64,198,198
2019,7,94,9402,PAPUA,JAYAWIJAYA,577,1075,618,457,0,0,0,2,0,2,0,6,0,72,0,2,0,2,2,6,72,2,0,33,52,0,1,0,57,27,84,86
2019,7,94,9403,PAPUA,JAYAPURA,8587,9070,7228,1842,0,26,0,272,0,426,0,414,0,1116,0,46,0,298,426,414,1116,46,0,1503,432,32,330,3,1164,1136,2300,2300
2019,7,94,9404,PAPUA,NABIRE,3886,4070,4092,303,0,2,0,31,0,37,0,22,0,186,0,0,0,33,37,22,186,0,0,192,70,0,21,0,192,86,278,283
2019,7,94,9408,PAPUA,KEPULAUAN YAPEN,945,1249,998,251,0,36,0,160,0,101,0,63,0,268,0,8,0,196,101,63,268,8,0,540,77,0,19,0,296,340,636,636
2019,7,94,9409,PAPUA,BIAK NUMFOR,4078,4496,4053,443,0,1,0,7,0,5,0,7,0,37,0,1,0,8,5,7,37,1,0,19,27,0,12,0,30,28,58,58
2019,7,94,9410,PAPUA,PANIAI,349,349,199,150,0,0,0,3,0,2,0,1,0,23,0,0,0,3,2,1,23,0,0,23,5,1,0,0,16,13,29,29
2019,7,94,9411,PAPUA,PUNCAK JAYA,0,399,399,0,0,1,0,4,0,1,0,3,0,20,0,1,0,5,1,3,20,1,0,21,9,0,0,0,16,14,30,30
2019,7,94,9412,PAPUA,MIMIKA,21640,23298,21922,1373,3,70,0,971,0,1057,0,862,0,5421,0,52,0,1041,1057,862,5421,52,0,4715,3184,211,323,0,4811,3622,8433,8433
2019,7,94,9413,PAPUA,BOVEN DIGOEL,2252,2523,1838,685,0,14,0,129,0,95,0,61,0,375,0,12,0,143,95,61,375,12,0,441,106,0,127,0,398,288,686,674
2019,7,94,9414,PAPUA,MAPPI,2012,2571,1795,776,0,5,0,58,0,49,0,26,0,67,0,0,0,63,49,26,67,0,0,140,24,0,41,0,108,97,205,205
2019,7,94,9415,PAPUA,ASMAT,2308,2307,1907,400,0,12,0,119,0,91,0,46,0,416,0,4,0,131,91,46,416,4,0,442,200,0,50,0,374,314,688,692
2019,7,94,9416,PAPUA,YAHUKIMO,0,0,0,0,0,0,0,0,0,0,0,0,0,0,0,0,0,0,0,0,0,0,0,0,0,0,0,0,0,0,0,0
2019,7,94,9417,PAPUA,PEGUNUNGAN BINTANG,66,71,58,13,0,2,0,7,0,3,0,6,0,37,0,1,0,9,3,6,37,1,0,29,26,0,1,0,38,18,56,56
2019,7,94,9418,PAPUA,TOLIKARA,0,0,0,0,0,0,0,0,0,0,0,0,0,0,0,0,0,0,0,0,0,0,0,0,0,0,0,0,0,0,0,0
2019,7,94,9419,PAPUA,SARMI,2020,3082,2595,487,0,17,0,235,0,278,0,178,0,684,0,16,0,252,278,178,684,16,0,911,334,9,163,0,747,661,1408,1417
2019,7,94,9420,PAPUA,KEEROM,3002,5453,4688,765,0,15,0,154,0,192,0,145,0,755,0,558,0,169,192,145,755,558,0,1175,433,32,186,0,991,828,1819,1826
2019,7,94,9426,PAPUA,WAROPEN,0,425,387,38,0,10,0,42,0,32,0,20,0,151,0,8,0,52,32,20,151,8,0,246,13,0,8,0,135,128,263,267
2019,7,94,9427,PAPUA,SUPIORI,198,269,135,134,0,0,0,1,0,2,0,1,0,4,0,0,0,1,2,1,4,0,0,2,5,0,1,0,2,6,8,8
2019,7,94,9428,PAPUA,MAMBERAMO RAYA,145,945,880,65,0,38,0,176,0,148,0,57,0,443,0,1,0,214,148,57,443,1,0,750,94,0,19,0,449,414,863,863
2019,7,94,9429,PAPUA,NDUGA,0,0,0,0,0,0,0,0,0,0,0,0,0,0,0,0,0,0,0,0,0,0,0,0,0,0,0,0,0,0,0,0
2019,7,94,9430,PAPUA,LANNY JAYA,0,133,52,81,0,0,0,0,0,0,0,0,0,14,0,0,0,0,0,0,14,0,0,6,3,0,5,0,12,2,14,14
2019,7,94,9431,PAPUA,MAMBERAMO TENGAH,0,53,16,37,0,0,0,2,0,4,0,0,0,1,0,0,0,2,4,0,1,0,0,6,0,0,1,0,3,4,7,7
2019,7,94,9432,PAPUA,YALIMO,278,279,268,11,0,0,0,4,0,2,0,2,0,25,0,0,0,4,2,2,25,0,0,10,21,0,2,0,19,14,33,33
2019,7,94,9433,PAPUA,PUNCAK,0,95,49,46,0,1,0,6,0,8,0,3,0,53,0,0,0,7,8,3,53,0,0,28,32,0,11,0,50,21,71,71
2019,7,94,9434,PAPUA,DOGIYAI,24,26,7,19,0,0,0,0,0,0,0,0,0,0,0,0,0,0,0,0,0,0,0,0,0,0,0,0,0,0,0,0
2019,7,94,9435,PAPUA,INTAN JAYA,0,136,0,136,0,0,0,3,0,3,0,1,0,13,0,0,0,3,3,1,13,0,0,7,7,0,6,0,13,7,20,20
2019,7,94,9436,PAPUA,DEIYAI,0,22,4,18,0,0,0,0,0,0,0,1,0,5,0,0,0,0,0,1,5,0,0,4,2,0,0,0,2,4,6,6
2019,7,94,9471,PAPUA,KOTA JAYAPURA,5165,9298,8921,377,0,23,0,223,0,291,0,312,0,2039,0,41,0,246,291,312,2039,41,0,1755,1022,23,131,0,1848,1081,2929,2931
2019,8,91,9101,PAPUA BARAT,FAKFAK,2131,2693,2583,110,0,0,0,8,0,5,0,2,0,20,0,0,0,8,5,2,20,0,0,9,22,0,4,0,18,17,35,35
2019,8,91,9102,PAPUA BARAT,KAIMANA,355,477,330,147,0,2,0,5,0,4,0,2,0,2,0,0,0,7,4,2,2,0,0,6,3,0,6,0,8,7,15,15
2019,8,91,9103,PAPUA BARAT,TELUK WONDAMA,569,1045,728,317,0,1,0,30,0,24,0,9,0,40,0,2,0,31,24,9,40,2,0,87,14,0,5,0,54,52,106,106
2019,8,91,9104,PAPUA BARAT,TELUK BINTUNI,125,424,229,195,0,1,0,2,0,0,0,0,0,2,0,0,0,3,0,0,2,0,0,1,3,0,1,0,4,1,5,5
2019,8,91,9105,PAPUA BARAT,MANOKWARI,4510,4693,4323,370,0,10,0,40,0,32,0,19,0,113,0,3,0,50,32,19,113,3,0,71,125,0,22,0,134,83,217,218
2019,8,91,9106,PAPUA BARAT,SORONG SELATAN,228,243,171,72,0,0,0,0,0,0,0,0,0,0,0,0,0,0,0,0,0,0,0,0,0,0,0,0,0,0,0,0
2019,8,91,9107,PAPUA BARAT,SORONG,904,1377,445,932,0,0,0,4,0,7,0,3,0,10,0,0,0,4,7,3,10,0,0,5,16,0,3,0,13,11,24,24
2019,8,91,9108,PAPUA BARAT,RAJA AMPAT,162,714,52,662,0,0,0,2,0,2,0,2,0,10,0,0,0,2,2,2,10,0,0,8,4,0,4,0,12,4,16,16
2019,8,91,9109,PAPUA BARAT,TAMBRAUW,142,156,35,121,0,0,0,6,0,3,0,2,0,7,0,0,0,6,3,2,7,0,0,11,3,0,4,0,10,8,18,18
2019,8,91,9110,PAPUA BARAT,MAYBRAT,30,31,0,31,0,0,0,0,0,0,0,0,0,0,0,0,0,0,0,0,0,0,0,0,0,0,0,0,0,0,0,0
2019,8,91,9111,PAPUA BARAT,MANOKWARI SELATAN,492,529,473,56,0,2,0,6,0,6,0,3,0,27,0,0,0,8,6,3,27,0,0,21,15,0,8,0,23,21,44,44
2019,8,91,9112,PAPUA BARAT,PEGUNUNGAN ARFAK,0,0,0,0,0,0,0,0,0,0,0,0,0,0,0,0,0,0,0,0,0,0,0,0,0,0,0,0,0,0,0,0
2019,8,91,9171,PAPUA BARAT,KOTA SORONG,830,1004,580,424,0,0,0,2,0,3,0,3,0,23,0,0,0,2,3,3,23,0,0,12,17,0,2,0,20,11,31,31
2019,8,94,9401,PAPUA,MERAUKE,1589,2448,1471,977,0,4,0,22,0,15,0,14,0,120,0,10,0,26,15,14,120,10,0,44,139,0,3,0,122,63,185,186
2019,8,94,9402,PAPUA,JAYAWIJAYA,569,2307,650,1657,0,0,0,1,0,3,0,0,0,34,0,1,0,1,3,0,34,1,0,12,27,0,1,0,28,11,39,40
2019,8,94,9403,PAPUA,JAYAPURA,7229,8534,6677,1857,0,14,0,248,0,377,0,321,0,972,0,46,0,262,377,321,972,46,0,1173,435,16,355,0,1064,914,1978,1979
2019,8,94,9404,PAPUA,NABIRE,3800,4202,3715,487,0,5,0,24,0,25,0,18,0,150,0,3,0,29,25,18,150,3,0,126,75,0,24,0,150,75,225,225
2019,8,94,9408,PAPUA,KEPULAUAN YAPEN,367,1015,714,301,0,35,0,148,0,125,0,62,0,224,0,8,0,183,125,62,224,8,0,488,66,0,48,0,265,337,602,602
2019,8,94,9409,PAPUA,BIAK NUMFOR,3596,4184,3849,335,0,0,0,3,0,6,0,1,0,34,0,2,0,3,6,1,34,2,0,29,15,0,2,0,32,14,46,46
2019,8,94,9410,PAPUA,PANIAI,301,301,154,147,0,0,0,1,0,1,0,2,0,17,0,0,0,1,1,2,17,0,0,15,5,1,0,0,14,7,21,21
2019,8,94,9411,PAPUA,PUNCAK JAYA,0,586,586,0,0,0,0,6,0,2,0,1,0,30,0,0,0,6,2,1,30,0,0,29,10,0,0,0,30,9,39,39
2019,8,94,9412,PAPUA,MIMIKA,20586,22546,20402,2144,0,93,0,872,0,964,0,744,0,4776,0,52,0,965,964,744,4776,52,0,3925,3038,154,384,0,4175,3326,7501,7501
2019,8,94,9413,PAPUA,BOVEN DIGOEL,1938,2380,1509,871,0,11,0,107,0,74,0,43,0,288,0,16,0,118,74,43,288,16,0,337,123,3,74,0,314,225,539,537
2019,8,94,9414,PAPUA,MAPPI,1667,2006,1475,531,0,10,0,54,0,52,0,27,0,83,0,1,0,64,52,27,83,1,0,141,31,0,55,0,125,102,227,227
2019,8,94,9415,PAPUA,ASMAT,1119,1119,615,504,0,23,0,102,0,81,0,44,0,180,0,2,0,125,81,44,180,2,0,269,78,0,87,0,232,200,432,434
2019,8,94,9416,PAPUA,YAHUKIMO,0,0,0,0,0,0,0,0,0,0,0,0,0,0,0,0,0,0,0,0,0,0,0,0,0,0,0,0,0,0,0,0
2019,8,94,9417,PAPUA,PEGUNUNGAN BINTANG,150,155,120,35,0,2,0,25,0,12,0,0,0,69,0,0,0,27,12,0,69,0,0,73,29,1,5,0,66,42,108,108
2019,8,94,9418,PAPUA,TOLIKARA,0,0,0,0,0,0,0,0,0,0,0,0,0,0,0,0,0,0,0,0,0,0,0,0,0,0,0,0,0,0,0,0
2019,8,94,9419,PAPUA,SARMI,2409,3669,2728,941,0,15,0,238,0,290,0,203,0,811,0,15,0,253,290,203,811,15,0,974,398,20,183,0,874,698,1572,1575
2019,8,94,9420,PAPUA,KEEROM,3389,5847,5192,655,0,9,0,154,0,177,0,137,0,633,0,567,0,163,177,137,633,567,0,995,450,56,186,0,945,732,1677,1687
2019,8,94,9426,PAPUA,WAROPEN,0,441,408,33,0,13,0,46,0,34,0,11,0,117,0,5,0,59,34,11,117,5,0,218,6,0,2,0,107,119,226,226
2019,8,94,9427,PAPUA,SUPIORI,180,180,71,109,0,0,0,0,0,0,0,0,0,5,0,0,0,0,0,0,5,0,0,3,2,0,0,0,2,3,5,5
2019,8,94,9428,PAPUA,MAMBERAMO RAYA,120,817,746,71,0,37,0,147,0,126,0,43,0,385,0,4,0,184,126,43,385,4,0,634,85,0,23,0,390,352,742,742
2019,8,94,9429,PAPUA,NDUGA,0,0,0,0,0,0,0,0,0,0,0,0,0,0,0,0,0,0,0,0,0,0,0,0,0,0,0,0,0,0,0,0
2019,8,94,9430,PAPUA,LANNY JAYA,0,54,16,38,0,0,0,1,0,1,0,1,0,6,0,0,0,1,1,1,6,0,0,2,0,0,7,0,8,1,9,9
2019,8,94,9431,PAPUA,MAMBERAMO TENGAH,0,58,15,43,0,0,0,0,0,1,0,2,0,5,0,0,0,0,1,2,5,0,0,2,3,0,3,0,4,4,8,8
2019,8,94,9432,PAPUA,YALIMO,261,262,251,11,0,0,0,4,0,0,0,0,0,12,0,0,0,4,0,0,12,0,0,4,10,0,2,0,10,6,16,16
2019,8,94,9433,PAPUA,PUNCAK,0,98,48,50,0,2,0,2,0,5,0,5,0,56,0,0,0,4,5,5,56,0,0,24,33,0,13,0,48,22,70,70
2019,8,94,9434,PAPUA,DOGIYAI,23,23,0,23,0,0,0,0,0,0,0,0,0,0,0,0,0,0,0,0,0,0,0,0,0,0,0,0,0,0,0,0
2019,8,94,9435,PAPUA,INTAN JAYA,0,81,0,81,0,0,0,1,0,0,0,0,0,9,0,0,0,1,0,0,9,0,0,2,8,0,0,0,3,7,10,10
2019,8,94,9436,PAPUA,DEIYAI,0,10,0,10,0,0,0,0,0,2,0,1,0,2,0,0,0,0,2,1,2,0,0,2,3,0,0,0,2,3,5,5
2019,8,94,9471,PAPUA,KOTA JAYAPURA,4440,7285,6957,328,0,9,0,154,0,225,0,198,0,1507,0,26,0,163,225,198,1507,26,0,1200,828,17,79,0,1354,765,2119,2124
2019,9,91,9101,PAPUA BARAT,FAKFAK,1955,2175,1981,194,0,1,0,3,0,5,0,3,0,10,0,1,0,4,5,3,10,1,0,12,7,0,4,0,17,6,23,23
2019,9,91,9102,PAPUA BARAT,KAIMANA,250,345,282,63,0,0,0,1,0,2,0,0,0,2,0,1,0,1,2,0,2,1,0,5,1,0,0,0,5,1,6,6
2019,9,91,9103,PAPUA BARAT,TELUK WONDAMA,471,787,518,269,0,2,0,25,0,13,0,9,0,28,0,2,0,27,13,9,28,2,0,56,21,0,2,0,42,37,79,79
2019,9,91,9104,PAPUA BARAT,TELUK BINTUNI,31,41,21,20,0,0,0,0,0,0,0,0,0,1,0,0,0,0,0,0,1,0,0,0,1,0,0,0,1,0,1,1
2019,9,91,9105,PAPUA BARAT,MANOKWARI,4234,4532,4162,370,0,7,0,43,0,31,0,16,0,110,0,10,0,50,31,16,110,10,0,65,134,0,18,0,139,78,217,217
2019,9,91,9106,PAPUA BARAT,SORONG SELATAN,118,152,3,149,0,0,0,0,0,0,0,0,0,1,0,0,0,0,0,0,1,0,0,1,0,0,0,0,1,0,1,1
2019,9,91,9107,PAPUA BARAT,SORONG,608,1893,1393,500,0,0,0,7,0,10,0,4,0,15,0,1,0,7,10,4,15,1,0,2,33,0,2,0,16,21,37,37
2019,9,91,9108,PAPUA BARAT,RAJA AMPAT,66,90,9,81,0,0,0,1,0,3,0,0,0,3,0,0,0,1,3,0,3,0,0,4,2,0,1,0,3,4,7,7
2019,9,91,9109,PAPUA BARAT,TAMBRAUW,109,116,45,71,0,0,0,1,0,6,0,5,0,5,0,1,0,1,6,5,5,1,0,14,0,0,4,0,10,8,18,18
2019,9,91,9110,PAPUA BARAT,MAYBRAT,49,52,0,52,0,0,0,0,0,0,0,0,0,0,0,0,0,0,0,0,0,0,0,0,0,0,0,0,0,0,0,0
2019,9,91,9111,PAPUA BARAT,MANOKWARI SELATAN,378,1402,1366,36,0,0,0,5,0,2,0,3,0,23,0,0,0,5,2,3,23,0,0,15,12,0,6,0,22,11,33,33
2019,9,91,9112,PAPUA BARAT,PEGUNUNGAN ARFAK,0,0,0,0,0,0,0,0,0,0,0,0,0,0,0,0,0,0,0,0,0,0,0,0,0,0,0,0,0,0,0,0
2019,9,91,9171,PAPUA BARAT,KOTA SORONG,778,1418,942,476,0,0,0,1,0,7,0,8,0,31,0,1,0,1,7,8,31,1,0,13,33,0,2,0,31,17,48,48
2019,9,94,9401,PAPUA,MERAUKE,1771,2906,1871,1035,0,3,0,31,0,21,0,12,0,114,0,2,0,34,21,12,114,2,0,17,161,0,5,0,108,75,183,183
2019,9,94,9402,PAPUA,JAYAWIJAYA,423,499,366,133,0,1,0,0,0,2,0,0,0,25,0,0,0,1,2,0,25,0,0,8,20,0,0,0,17,11,28,28
2019,9,94,9403,PAPUA,JAYAPURA,8649,9067,7255,1812,0,24,0,192,0,259,0,219,0,775,0,24,0,216,259,219,775,24,0,908,355,29,200,1,816,677,1493,1493
2019,9,94,9404,PAPUA,NABIRE,3815,4173,3600,573,0,6,0,22,0,20,0,14,0,126,0,2,0,28,20,14,126,2,0,106,68,2,15,0,116,74,190,191
2019,9,94,9408,PAPUA,KEPULAUAN YAPEN,308,961,697,264,0,20,0,104,0,69,0,33,0,148,0,4,0,124,69,33,148,4,0,320,48,0,10,0,162,216,378,378
2019,9,94,9409,PAPUA,BIAK NUMFOR,4648,6274,4789,1485,0,0,0,6,0,8,0,10,0,53,0,1,0,6,8,10,53,1,0,37,38,0,3,0,44,34,78,78
2019,9,94,9410,PAPUA,PANIAI,309,309,163,146,0,0,0,5,0,4,0,1,0,22,0,0,0,5,4,1,22,0,0,26,5,1,0,0,19,13,32,32
2019,9,94,9411,PAPUA,PUNCAK JAYA,0,47,47,0,0,1,0,4,0,3,0,1,0,22,0,0,0,5,3,1,22,0,0,23,8,0,0,0,17,14,31,31
2019,9,94,9412,PAPUA,MIMIKA,23840,34589,32834,1755,0,86,0,1045,0,1116,0,926,0,5128,0,66,0,1131,1116,926,5128,66,0,4307,3420,155,485,0,4781,3586,8367,8367
2019,9,94,9413,PAPUA,BOVEN DIGOEL,2291,2854,1799,1055,0,13,0,130,0,76,0,31,0,334,0,11,0,143,76,31,334,11,0,371,134,1,89,0,340,255,595,595
2019,9,94,9414,PAPUA,MAPPI,1747,2080,1545,535,0,4,0,50,0,50,0,35,0,94,0,1,0,54,50,35,94,1,0,139,39,0,56,0,138,96,234,234
2019,9,94,9415,PAPUA,ASMAT,1145,1150,740,410,0,5,0,107,0,90,0,31,0,195,0,3,0,112,90,31,195,3,0,256,85,1,89,0,245,186,431,431
2019,9,94,9416,PAPUA,YAHUKIMO,0,0,0,0,0,0,0,0,0,0,0,0,0,0,0,0,0,0,0,0,0,0,0,0,0,0,0,0,0,0,0,0
2019,9,94,9417,PAPUA,PEGUNUNGAN BINTANG,72,74,43,31,0,2,0,6,0,5,0,5,0,42,0,0,0,8,5,5,42,0,0,40,20,0,0,0,36,24,60,60
2019,9,94,9418,PAPUA,TOLIKARA,0,0,0,0,0,0,0,0,0,0,0,0,0,0,0,0,0,0,0,0,0,0,0,0,0,0,0,0,0,0,0,0
2019,9,94,9419,PAPUA,SARMI,2067,2748,2107,641,0,7,0,175,0,218,0,131,0,643,0,10,0,182,218,131,643,10,0,716,307,22,139,0,668,516,1184,1184
2019,9,94,9420,PAPUA,KEEROM,3297,4916,4257,659,0,10,0,110,0,160,0,118,0,635,0,570,0,120,160,118,635,570,0,926,485,48,155,0,901,702,1603,1614
2019,9,94,9426,PAPUA,WAROPEN,0,558,539,19,0,10,0,75,0,46,0,24,0,146,0,3,0,85,46,24,146,3,0,292,6,0,6,0,136,168,304,304
2019,9,94,9427,PAPUA,SUPIORI,959,1018,908,110,0,0,0,0,0,0,0,0,0,5,0,0,0,0,0,0,5,0,0,4,1,0,0,0,3,2,5,5
2019,9,94,9428,PAPUA,MAMBERAMO RAYA,229,978,928,50,0,51,0,208,0,155,0,53,0,386,0,27,0,259,155,53,386,27,0,737,116,0,28,0,458,422,880,881
2019,9,94,9429,PAPUA,NDUGA,0,0,0,0,0,0,0,0,0,0,0,0,0,0,0,0,0,0,0,0,0,0,0,0,0,0,0,0,0,0,0,0
2019,9,94,9430,PAPUA,LANNY JAYA,0,33,13,20,0,0,0,0,0,1,0,0,0,6,0,0,0,0,1,0,6,0,0,3,3,0,1,0,6,1,7,7
2019,9,94,9431,PAPUA,MAMBERAMO TENGAH,0,71,31,40,0,0,0,2,0,3,0,3,0,7,0,0,0,2,3,3,7,0,0,8,5,0,2,0,9,6,15,15
2019,9,94,9432,PAPUA,YALIMO,210,210,194,16,0,0,0,1,0,0,0,0,0,9,0,0,0,1,0,0,9,0,0,2,5,0,3,0,7,3,10,10
2019,9,94,9433,PAPUA,PUNCAK,0,164,72,92,0,0,0,2,0,3,0,9,0,96,0,0,0,2,3,9,96,0,0,29,72,0,9,0,66,44,110,110
2019,9,94,9434,PAPUA,DOGIYAI,26,26,0,26,0,0,0,0,0,0,0,0,0,0,0,0,0,0,0,0,0,0,0,0,0,0,0,0,0,0,0,0
2019,9,94,9435,PAPUA,INTAN JAYA,0,89,1,88,0,0,0,1,0,2,0,0,0,7,0,0,0,1,2,0,7,0,0,6,4,0,0,0,5,5,10,10
2019,9,94,9436,PAPUA,DEIYAI,0,52,2,50,0,0,0,1,0,1,0,2,0,5,0,0,0,1,1,2,5,0,0,4,2,0,3,0,6,3,9,9
2019,9,94,9471,PAPUA,KOTA JAYAPURA,4452,7410,6942,468,0,15,0,168,0,191,0,176,0,1475,0,18,0,183,191,176,1475,18,0,1081,859,19,87,0,1269,774,2043,2046
2019,10,91,9101,PAPUA BARAT,FAKFAK,1075,1798,998,800,0,1,0,1,0,6,0,2,0,19,0,0,0,2,6,2,19,0,0,17,11,0,1,0,20,9,29,29
2019,10,91,9102,PAPUA BARAT,KAIMANA,306,503,305,198,0,0,0,1,0,1,0,0,0,8,0,0,0,1,1,0,8,0,0,3,7,0,0,0,5,5,10,10
2019,10,91,9103,PAPUA BARAT,TELUK WONDAMA,485,967,592,375,0,5,0,33,0,14,0,11,0,23,0,2,0,38,14,11,23,2,0,62,21,0,5,0,49,39,88,88
2019,10,91,9104,PAPUA BARAT,TELUK BINTUNI,11,34,29,5,0,0,0,0,0,0,0,0,0,0,0,0,0,0,0,0,0,0,0,0,0,0,0,0,0,0,0,0
2019,10,91,9105,PAPUA BARAT,MANOKWARI,4931,5051,4673,378,0,6,0,27,0,16,0,19,0,113,0,4,0,33,16,19,113,4,0,53,111,0,22,0,106,79,185,186
2019,10,91,9106,PAPUA BARAT,SORONG SELATAN,338,364,40,324,0,0,0,0,0,0,0,0,0,0,0,0,0,0,0,0,0,0,0,0,0,0,0,0,0,0,0,0
2019,10,91,9107,PAPUA BARAT,SORONG,763,1163,370,793,0,0,0,4,0,8,0,1,0,11,0,0,0,4,8,1,11,0,0,2,18,0,4,0,15,9,24,24
2019,10,91,9108,PAPUA BARAT,RAJA AMPAT,110,126,73,53,0,1,0,0,0,3,0,0,0,8,0,0,0,1,3,0,8,0,0,7,5,0,0,0,5,7,12,12
2019,10,91,9109,PAPUA BARAT,TAMBRAUW,104,352,275,77,0,1,0,5,0,4,0,4,0,6,0,0,0,6,4,4,6,0,0,14,2,0,4,0,12,8,20,20
2019,10,91,9110,PAPUA BARAT,MAYBRAT,78,81,3,78,0,0,0,0,0,1,0,0,0,3,0,0,0,0,1,0,3,0,0,3,1,0,0,0,3,1,4,4
2019,10,91,9111,PAPUA BARAT,MANOKWARI SELATAN,392,2967,2924,43,0,1,0,9,0,5,0,3,0,28,0,0,0,10,5,3,28,0,0,22,20,0,4,0,24,22,46,46
2019,10,91,9112,PAPUA BARAT,PEGUNUNGAN ARFAK,0,0,0,0,0,0,0,0,0,0,0,0,0,0,0,0,0,0,0,0,0,0,0,0,0,0,0,0,0,0,0,0
2019,10,91,9171,PAPUA BARAT,KOTA SORONG,805,1046,530,516,0,0,0,4,0,5,0,3,0,22,0,2,0,4,5,3,22,2,0,14,18,0,4,0,26,10,36,36
2019,10,94,9401,PAPUA,MERAUKE,1485,1925,1224,638,63,5,0,14,0,13,0,5,0,91,0,4,0,19,13,5,91,4,0,15,116,1,0,0,80,52,132,132
2019,10,94,9402,PAPUA,JAYAWIJAYA,197,211,185,26,0,0,0,0,0,0,0,0,0,10,0,0,0,0,0,0,10,0,0,1,9,0,0,0,7,3,10,10
2019,10,94,9403,PAPUA,JAYAPURA,7681,8196,6814,1382,0,23,0,157,0,210,0,177,0,511,0,25,0,180,210,177,511,25,0,676,247,10,170,0,604,499,1103,1103
2019,10,94,9404,PAPUA,NABIRE,3489,4035,3454,581,0,2,0,13,0,14,0,11,0,134,0,0,0,15,14,11,134,0,0,94,66,1,13,0,106,68,174,174
2019,10,94,9408,PAPUA,KEPULAUAN YAPEN,297,633,477,156,0,15,0,77,0,54,0,37,0,129,0,5,0,92,54,37,129,5,0,264,30,0,23,0,130,187,317,317
2019,10,94,9409,PAPUA,BIAK NUMFOR,3805,4218,3852,366,0,1,0,4,0,7,0,4,0,56,0,3,0,5,7,4,56,3,0,39,34,0,3,0,39,36,75,76
2019,10,94,9410,PAPUA,PANIAI,330,330,203,127,0,0,0,2,0,3,0,0,0,20,0,0,0,2,3,0,20,0,0,20,6,0,0,0,9,16,25,26
2019,10,94,9411,PAPUA,PUNCAK JAYA,0,88,88,0,0,2,0,8,0,11,0,1,0,39,0,0,0,10,11,1,39,0,0,50,12,0,0,0,30,31,61,62
2019,10,94,9412,PAPUA,MIMIKA,18984,20026,18537,1488,1,81,0,810,0,855,0,644,0,4090,0,44,0,891,855,644,4090,44,0,3219,2803,108,394,0,3747,2777,6524,6524
2019,10,94,9413,PAPUA,BOVEN DIGOEL,2054,2702,1627,1075,0,12,0,123,0,83,0,40,0,276,0,15,0,135,83,40,276,15,0,334,113,0,102,0,298,251,549,549
2019,10,94,9414,PAPUA,MAPPI,1892,2313,1655,658,0,9,0,89,0,81,0,34,0,110,0,2,0,98,81,34,110,2,0,220,26,0,79,0,144,181,325,325
2019,10,94,9415,PAPUA,ASMAT,1479,1518,1012,506,0,25,0,176,0,107,0,42,0,242,0,5,0,201,107,42,242,5,0,332,137,0,128,0,321,276,597,597
2019,10,94,9416,PAPUA,YAHUKIMO,0,0,0,0,0,0,0,0,0,0,0,0,0,0,0,0,0,0,0,0,0,0,0,0,0,0,0,0,0,0,0,0
2019,10,94,9417,PAPUA,PEGUNUNGAN BINTANG,39,41,26,15,0,1,0,8,0,7,0,0,0,15,0,0,0,9,7,0,15,0,0,20,10,0,1,0,21,10,31,31
2019,10,94,9418,PAPUA,TOLIKARA,0,0,0,0,0,0,0,0,0,0,0,0,0,0,0,0,0,0,0,0,0,0,0,0,0,0,0,0,0,0,0,0
2019,10,94,9419,PAPUA,SARMI,2257,3090,2318,772,0,18,0,173,0,209,0,147,0,513,0,16,0,191,209,147,513,16,0,615,271,16,174,0,601,475,1076,1076
2019,10,94,9420,PAPUA,KEEROM,2725,4363,3657,706,0,13,0,131,0,170,0,142,0,711,0,392,0,144,170,142,711,392,0,870,452,49,192,0,894,665,1559,1563
2019,10,94,9426,PAPUA,WAROPEN,0,385,376,9,0,10,0,33,0,34,0,10,0,98,0,6,0,43,34,10,98,6,0,181,7,0,3,0,83,108,191,191
2019,10,94,9427,PAPUA,SUPIORI,189,223,115,108,0,0,0,0,0,0,0,0,0,0,0,0,0,0,0,0,0,0,0,0,0,0,0,0,0,0,0,0
2019,10,94,9428,PAPUA,MAMBERAMO RAYA,256,863,852,11,0,66,0,136,0,133,0,47,0,402,0,1,0,202,133,47,402,1,0,689,86,0,10,0,446,339,785,785
2019,10,94,9429,PAPUA,NDUGA,0,0,0,0,0,0,0,0,0,0,0,0,0,0,0,0,0,0,0,0,0,0,0,0,0,0,0,0,0,0,0,0
2019,10,94,9430,PAPUA,LANNY JAYA,0,65,2,63,0,0,0,0,0,0,0,0,0,6,0,0,0,0,0,0,6,0,0,3,2,0,1,0,4,2,6,6
2019,10,94,9431,PAPUA,MAMBERAMO TENGAH,0,11,5,6,0,0,0,0,0,0,0,0,0,3,0,0,0,0,0,0,3,0,0,0,3,0,0,0,1,2,3,3
2019,10,94,9432,PAPUA,YALIMO,60,60,0,60,0,0,0,1,0,1,0,0,0,5,0,0,0,1,1,0,5,0,0,1,5,0,1,0,6,1,7,7
2019,10,94,9433,PAPUA,PUNCAK,0,136,4,132,0,0,0,3,0,4,0,4,0,56,0,0,0,3,4,4,56,0,0,17,42,0,8,0,38,29,67,67
2019,10,94,9434,PAPUA,DOGIYAI,15,15,0,15,0,0,0,0,0,0,0,0,0,0,0,0,0,0,0,0,0,0,0,0,0,0,0,0,0,0,0,0
2019,10,94,9435,PAPUA,INTAN JAYA,0,52,0,52,0,0,0,0,0,0,0,1,0,4,0,0,0,0,0,1,4,0,0,1,4,0,0,0,2,3,5,5
2019,10,94,9436,PAPUA,DEIYAI,0,61,3,58,0,2,0,0,0,1,0,0,0,7,0,0,0,2,1,0,7,0,0,2,6,0,2,0,4,6,10,10
2019,10,94,9471,PAPUA,KOTA JAYAPURA,4532,6783,6527,256,0,16,0,116,0,187,0,146,0,1210,0,14,0,132,187,146,1210,14,0,828,756,17,85,0,1085,604,1689,1686
2019,11,91,9101,PAPUA BARAT,FAKFAK,672,907,811,96,0,0,0,1,0,2,0,0,0,8,0,1,0,1,2,0,8,1,0,10,2,0,0,0,10,2,12,12
2019,11,91,9102,PAPUA BARAT,KAIMANA,282,2456,2368,88,0,0,0,2,0,1,0,0,0,7,0,0,0,2,1,0,7,0,0,6,3,0,1,0,6,4,10,10
2019,11,91,9103,PAPUA BARAT,TELUK WONDAMA,359,641,447,194,0,2,0,7,0,8,0,5,0,16,0,0,0,9,8,5,16,0,0,23,15,0,0,0,20,18,38,38
2019,11,91,9104,PAPUA BARAT,TELUK BINTUNI,27,39,24,15,0,0,0,0,0,0,0,1,0,1,0,0,0,0,0,1,1,0,0,1,1,0,0,0,2,0,2,2
2019,11,91,9105,PAPUA BARAT,MANOKWARI,5244,5351,5051,300,0,4,0,27,0,24,0,16,0,116,0,2,0,31,24,16,116,2,0,71,111,0,9,0,127,62,189,191
2019,11,91,9106,PAPUA BARAT,SORONG SELATAN,151,257,2,255,0,0,0,0,0,0,0,0,0,6,0,0,0,0,0,0,6,0,0,0,4,0,2,0,1,5,6,6
2019,11,91,9107,PAPUA BARAT,SORONG,483,764,298,466,0,0,0,6,0,0,0,2,0,7,0,1,0,6,0,2,7,1,0,4,8,0,4,0,13,3,16,16
2019,11,91,9108,PAPUA BARAT,RAJA AMPAT,58,221,0,221,0,0,0,1,0,2,0,3,0,19,0,0,0,1,2,3,19,0,0,11,8,0,6,0,21,4,25,25
2019,11,91,9109,PAPUA BARAT,TAMBRAUW,83,88,39,49,0,0,0,5,0,1,0,1,0,7,0,0,0,5,1,1,7,0,0,8,4,0,2,0,8,6,14,14
2019,11,91,9110,PAPUA BARAT,MAYBRAT,61,63,9,54,0,0,0,1,0,0,0,0,0,0,0,0,0,1,0,0,0,0,0,0,1,0,0,0,0,1,1,1
2019,11,91,9111,PAPUA BARAT,MANOKWARI SELATAN,397,1528,1479,49,0,0,0,7,0,4,0,3,0,22,0,0,0,7,4,3,22,0,0,14,21,0,1,0,16,20,36,36
2019,11,91,9112,PAPUA BARAT,PEGUNUNGAN ARFAK,0,0,0,0,0,0,0,0,0,0,0,0,0,0,0,0,0,0,0,0,0,0,0,0,0,0,0,0,0,0,0,0
2019,11,91,9171,PAPUA BARAT,KOTA SORONG,637,2287,1899,388,0,1,0,6,0,3,0,5,0,13,0,0,0,7,3,5,13,0,0,17,9,0,2,0,19,9,28,28
2019,11,94,9401,PAPUA,MERAUKE,1466,1753,1175,578,0,1,0,17,0,12,0,7,0,71,0,4,0,18,12,7,71,4,0,17,90,0,5,0,71,41,112,112
2019,11,94,9402,PAPUA,JAYAWIJAYA,356,466,360,106,0,0,0,2,0,3,0,1,0,21,0,0,0,2,3,1,21,0,0,12,13,0,2,0,16,11,27,27
2019,11,94,9403,PAPUA,JAYAPURA,7481,8160,6814,1346,0,13,0,178,0,263,0,261,0,740,0,33,0,191,263,261,740,33,0,1003,297,7,181,0,794,694,1488,1488
2019,11,94,9404,PAPUA,NABIRE,2580,2911,2458,453,0,2,0,17,0,18,0,20,0,134,0,1,0,19,18,20,134,1,0,112,69,1,12,0,123,69,192,194
2019,11,94,9408,PAPUA,KEPULAUAN YAPEN,271,417,168,249,0,7,0,46,0,31,0,25,0,73,0,1,0,53,31,25,73,1,0,153,10,0,20,0,89,94,183,183
2019,11,94,9409,PAPUA,BIAK NUMFOR,3318,3625,3365,260,0,1,0,4,0,9,0,2,0,29,0,1,0,5,9,2,29,1,0,19,22,0,5,0,28,18,46,46
2019,11,94,9410,PAPUA,PANIAI,218,216,95,121,0,0,0,2,0,0,0,0,0,12,0,0,0,2,0,0,12,0,0,9,5,0,0,0,7,7,14,14
2019,11,94,9411,PAPUA,PUNCAK JAYA,0,84,84,0,0,4,0,18,0,6,0,6,0,38,0,0,0,22,6,6,38,0,0,46,26,0,0,0,37,35,72,72
2019,11,94,9412,PAPUA,MIMIKA,19424,21644,20567,1077,0,74,0,970,0,1127,0,813,0,5107,0,47,0,1044,1127,813,5107,47,0,4292,3326,119,401,0,4509,3629,8138,8138
2019,11,94,9413,PAPUA,BOVEN DIGOEL,2045,3155,1536,1619,0,14,0,98,0,75,0,38,0,194,0,6,0,112,75,38,194,6,0,242,118,0,63,0,211,214,425,423
2019,11,94,9414,PAPUA,MAPPI,1641,1923,1299,624,0,14,0,71,0,69,0,23,0,78,0,0,0,85,69,23,78,0,0,163,35,0,57,0,141,114,255,255
2019,11,94,9415,PAPUA,ASMAT,1420,1422,984,438,0,22,0,143,0,110,0,50,0,317,0,8,0,165,110,50,317,8,0,356,147,0,148,0,365,285,650,651
2019,11,94,9416,PAPUA,YAHUKIMO,0,0,0,0,0,0,0,0,0,0,0,0,0,0,0,0,0,0,0,0,0,0,0,0,0,0,0,0,0,0,0,0
2019,11,94,9417,PAPUA,PEGUNUNGAN BINTANG,28,32,23,9,0,2,0,5,0,3,0,0,0,14,0,0,0,7,3,0,14,0,0,17,6,1,0,0,18,6,24,24
2019,11,94,9418,PAPUA,TOLIKARA,0,0,0,0,0,0,0,0,0,0,0,0,0,0,0,0,0,0,0,0,0,0,0,0,0,0,0,0,0,0,0,0
2019,11,94,9419,PAPUA,SARMI,1872,2658,1927,731,0,10,0,163,0,208,0,129,0,546,0,8,0,173,208,129,546,8,0,631,249,20,164,0,638,426,1064,1064
2019,11,94,9420,PAPUA,KEEROM,14744,16920,16118,802,0,15,0,208,0,289,0,268,0,945,0,293,0,223,289,268,945,293,0,1174,541,26,284,0,1143,875,2018,2025
2019,11,94,9426,PAPUA,WAROPEN,0,254,248,6,0,7,0,35,0,23,0,10,0,43,0,3,0,42,23,10,43,3,0,119,1,0,1,0,55,66,121,121
2019,11,94,9427,PAPUA,SUPIORI,208,273,169,104,0,0,0,0,0,0,0,0,0,0,0,0,0,0,0,0,0,0,0,0,0,0,0,0,0,0,0,0
2019,11,94,9428,PAPUA,MAMBERAMO RAYA,53,584,584,0,0,55,0,107,0,68,0,34,0,311,0,0,0,162,68,34,311,0,0,509,59,0,7,0,321,254,575,575
2019,11,94,9429,PAPUA,NDUGA,0,0,0,0,0,0,0,0,0,0,0,0,0,0,0,0,0,0,0,0,0,0,0,0,0,0,0,0,0,0,0,0
2019,11,94,9430,PAPUA,LANNY JAYA,0,66,22,44,0,0,0,0,0,0,0,0,0,7,0,0,0,0,0,0,7,0,0,2,1,0,4,0,6,1,7,7
2019,11,94,9431,PAPUA,MAMBERAMO TENGAH,0,4,0,4,0,0,0,0,0,0,0,0,0,0,0,0,0,0,0,0,0,0,0,0,0,0,0,0,0,0,0,0
2019,11,94,9432,PAPUA,YALIMO,46,46,0,46,0,0,0,1,0,3,0,0,0,11,0,0,0,1,3,0,11,0,0,4,6,0,5,0,13,2,15,15
2019,11,94,9433,PAPUA,PUNCAK,0,65,61,4,0,1,0,1,0,0,0,0,0,30,0,1,0,2,0,0,30,1,0,14,19,0,0,0,18,15,33,33
2019,11,94,9434,PAPUA,DOGIYAI,0,0,0,0,0,0,0,0,0,0,0,0,0,0,0,0,0,0,0,0,0,0,0,0,0,0,0,0,0,0,0,0
2019,11,94,9435,PAPUA,INTAN JAYA,0,37,3,34,0,0,0,0,0,0,0,0,0,3,0,0,0,0,0,0,3,0,0,1,0,0,2,0,3,0,3,3
2019,11,94,9436,PAPUA,DEIYAI,0,48,3,45,0,0,0,1,0,2,0,0,0,6,0,0,0,1,2,0,6,0,0,0,8,0,1,0,3,6,9,9
2019,11,94,9471,PAPUA,KOTA JAYAPURA,4425,7048,6664,384,0,16,0,147,0,225,0,178,0,1507,0,23,0,163,225,178,1507,23,0,1130,868,32,70,0,1371,725,2096,2100
2019,12,91,9101,PAPUA BARAT,FAKFAK,540,2029,1349,680,0,1,0,1,0,0,0,0,0,1,0,0,0,2,0,0,1,0,0,0,0,0,3,0,3,0,3,3
2019,12,91,9102,PAPUA BARAT,KAIMANA,143,399,165,234,0,0,0,1,0,1,0,1,0,5,0,0,0,1,1,1,5,0,0,1,6,0,1,0,7,1,8,8
2019,12,91,9103,PAPUA BARAT,TELUK WONDAMA,187,380,194,186,0,2,0,4,0,6,0,1,0,13,0,0,0,6,6,1,13,0,0,14,11,0,2,0,17,9,26,27
2019,12,91,9104,PAPUA BARAT,TELUK BINTUNI,17,38,29,9,0,0,0,0,0,0,0,0,0,1,0,0,0,0,0,0,1,0,0,1,0,0,0,0,1,0,1,1
2019,12,91,9105,PAPUA BARAT,MANOKWARI,4210,4238,4048,190,0,4,0,33,0,22,0,15,0,129,0,6,0,37,22,15,129,6,0,81,117,0,11,0,122,87,209,209
2019,12,91,9106,PAPUA BARAT,SORONG SELATAN,66,258,206,52,0,0,0,0,0,0,0,0,0,0,0,0,0,0,0,0,0,0,0,0,0,0,0,0,0,0,0,0
2019,12,91,9107,PAPUA BARAT,SORONG,422,733,312,421,0,0,0,0,0,1,0,0,0,5,0,0,0,0,1,0,5,0,0,2,3,0,1,0,5,1,6,6
2019,12,91,9108,PAPUA BARAT,RAJA AMPAT,26,447,205,242,0,0,0,0,0,1,0,0,0,10,0,0,0,0,1,0,10,0,0,4,6,0,1,0,1,10,11,11
2019,12,91,9109,PAPUA BARAT,TAMBRAUW,48,1191,2,1189,0,0,0,20,0,19,0,8,0,37,0,0,0,20,19,8,37,0,0,41,14,0,29,0,44,40,84,84
2019,12,91,9110,PAPUA BARAT,MAYBRAT,37,37,2,35,0,0,0,0,0,0,0,0,0,2,0,0,0,0,0,0,2,0,0,1,1,0,0,0,1,1,2,2
2019,12,91,9111,PAPUA BARAT,MANOKWARI SELATAN,256,724,661,63,0,3,0,3,0,6,0,3,0,21,0,1,0,6,6,3,21,1,0,9,27,0,1,0,22,15,37,37
2019,12,91,9112,PAPUA BARAT,PEGUNUNGAN ARFAK,0,0,0,0,0,0,0,0,0,0,0,0,0,0,0,0,0,0,0,0,0,0,0,0,0,0,0,0,0,0,0,0
2019,12,91,9171,PAPUA BARAT,KOTA SORONG,534,642,351,291,0,0,0,4,0,6,0,5,0,16,0,0,0,4,6,5,16,0,0,17,8,0,6,0,16,15,31,31
2019,12,94,9401,PAPUA,MERAUKE,1317,1479,1095,384,0,2,0,14,0,9,0,15,0,79,0,4,0,16,9,15,79,4,0,18,103,0,2,0,80,43,123,123
2019,12,94,9402,PAPUA,JAYAWIJAYA,296,318,286,32,0,0,0,1,0,0,0,3,0,56,0,1,0,1,0,3,56,1,0,26,32,0,4,0,38,23,61,62
2019,12,94,9403,PAPUA,JAYAPURA,7816,8413,6770,1643,0,18,0,185,0,232,0,171,0,697,0,17,0,203,232,171,697,17,0,763,318,11,226,2,689,631,1320,1320
2019,12,94,9404,PAPUA,NABIRE,1449,1632,1307,325,0,2,0,10,0,11,0,5,0,95,0,2,0,12,11,5,95,2,0,66,48,0,15,0,81,44,125,129
2019,12,94,9408,PAPUA,KEPULAUAN YAPEN,271,326,120,206,0,5,0,39,0,32,0,18,0,59,0,0,0,44,32,18,59,0,0,103,16,0,34,0,79,74,153,153
2019,12,94,9409,PAPUA,BIAK NUMFOR,2901,3505,2906,599,0,1,0,5,0,14,0,10,0,90,0,3,0,6,14,10,90,3,0,57,59,0,7,0,76,47,123,123
2019,12,94,9410,PAPUA,PANIAI,80,80,77,3,0,0,0,0,0,1,0,1,0,4,0,0,0,0,1,1,4,0,0,6,0,0,0,0,4,2,6,6
2019,12,94,9411,PAPUA,PUNCAK JAYA,0,49,49,0,0,0,0,6,0,5,0,1,0,15,0,1,0,6,5,1,15,1,0,21,7,0,0,0,13,15,28,28
2019,12,94,9412,PAPUA,MIMIKA,13545,14025,13368,657,0,63,0,621,0,522,0,369,0,2276,0,23,0,684,522,369,2276,23,0,1978,1560,131,205,0,2057,1817,3874,3874
2019,12,94,9413,PAPUA,BOVEN DIGOEL,1900,2434,1550,884,0,15,0,93,0,61,0,24,0,153,0,2,0,108,61,24,153,2,0,182,119,0,46,0,189,159,348,347
2019,12,94,9414,PAPUA,MAPPI,1517,1752,1327,425,0,11,0,52,0,53,0,16,0,66,0,1,0,63,53,16,66,1,0,135,27,1,36,0,107,92,199,199
2019,12,94,9415,PAPUA,ASMAT,1201,1229,655,574,0,11,0,121,0,100,0,38,0,224,0,2,0,132,100,38,224,2,0,232,132,0,132,0,255,241,496,496
2019,12,94,9416,PAPUA,YAHUKIMO,0,0,0,0,0,0,0,0,0,0,0,0,0,0,0,0,0,0,0,0,0,0,0,0,0,0,0,0,0,0,0,0
2019,12,94,9417,PAPUA,PEGUNUNGAN BINTANG,18,18,11,7,0,0,0,0,0,5,0,0,0,9,0,0,0,0,5,0,9,0,0,9,4,0,1,0,9,5,14,14
2019,12,94,9418,PAPUA,TOLIKARA,0,0,0,0,0,0,0,0,0,0,0,0,0,0,0,0,0,0,0,0,0,0,0,0,0,0,0,0,0,0,0,0
2019,12,94,9419,PAPUA,SARMI,395,845,511,334,0,5,0,80,0,107,0,64,0,227,0,7,0,85,107,64,227,7,0,259,115,6,110,0,253,237,490,490
2019,12,94,9420,PAPUA,KEEROM,3717,5659,4853,806,0,20,0,193,0,218,0,161,0,785,0,431,0,213,218,161,785,431,0,1031,517,36,225,0,1020,788,1808,1809
2019,12,94,9426,PAPUA,WAROPEN,0,197,197,0,0,9,0,22,0,13,0,6,0,53,0,2,0,31,13,6,53,2,0,105,0,0,0,0,50,55,105,105
2019,12,94,9427,PAPUA,SUPIORI,141,203,132,71,0,0,0,0,0,0,0,0,0,1,0,0,0,0,0,0,1,0,0,0,1,0,0,0,1,0,1,1
2019,12,94,9428,PAPUA,MAMBERAMO RAYA,0,640,634,6,0,53,0,128,0,111,0,31,0,315,0,2,0,181,111,31,315,2,0,585,53,0,2,0,359,281,640,640
2019,12,94,9429,PAPUA,NDUGA,0,0,0,0,0,0,0,0,0,0,0,0,0,0,0,0,0,0,0,0,0,0,0,0,0,0,0,0,0,0,0,0
2019,12,94,9430,PAPUA,LANNY JAYA,0,43,0,43,0,0,0,0,0,0,0,0,0,3,0,0,0,0,0,0,3,0,0,1,0,0,2,0,3,0,3,3
2019,12,94,9431,PAPUA,MAMBERAMO TENGAH,0,0,0,0,0,0,0,0,0,0,0,0,0,0,0,0,0,0,0,0,0,0,0,0,0,0,0,0,0,0,0,0
2019,12,94,9432,PAPUA,YALIMO,32,32,0,32,0,0,0,2,0,0,0,0,0,8,0,0,0,2,0,0,8,0,0,2,4,0,4,0,4,6,10,10
2019,12,94,9433,PAPUA,PUNCAK,0,96,11,85,0,0,0,3,0,8,0,7,0,81,0,1,0,3,8,7,81,1,0,17,66,0,17,0,61,39,100,100
2019,12,94,9434,PAPUA,DOGIYAI,0,0,0,0,0,0,0,0,0,0,0,0,0,0,0,0,0,0,0,0,0,0,0,0,0,0,0,0,0,0,0,0
2019,12,94,9435,PAPUA,INTAN JAYA,0,19,0,19,0,0,0,0,0,0,0,0,0,0,0,0,0,0,0,0,0,0,0,0,0,0,0,0,0,0,0,0
2019,12,94,9436,PAPUA,DEIYAI,0,22,0,22,0,0,0,0,0,0,0,0,0,2,0,0,0,0,0,0,2,0,0,0,1,0,1,0,0,2,2,2
2019,12,94,9471,PAPUA,KOTA JAYAPURA,4560,6880,6435,445,0,10,0,103,0,166,0,140,0,1273,0,30,0,113,166,140,1273,30,0,940,698,15,76,0,1079,643,1722,1729
